"","treat","Annualinc","Annualexp","redeff","age","distance","weights"
"3",0,1040400,881661,158739,44,0.0164718296070353,1
"6",1,643200,493899,149301,37,0.0555316121282107,1
"19",0,1117200,803227,313973,36,0.025313758610739,1
"20",1,584400,403115,181285,25,0.143054317064601,1
"29",1,411600,325860,85740,41,0.0617938740371072,1
"50",0,954000,740267,213733,54,0.00853839371071781,1
"54",0,573600,402513,171087,46,0.0312055976533376,1
"56",0,422400,286119,136281,21,0.236767304493912,1
"67",0,424800,321604,103196,23,0.21076708323833,1
"73",1,1212000,874492,337508,50,0.0071142364257009,1
"76",1,775200,579170,196030,37,0.043785109305117,1
"89",0,1168800,940038,228762,49,0.00866494098636841,1
"94",0,1000800,784722,216078,40,0.0235376644608357,1
"100",0,435600,340486,95114,20,0.250178996440493,1
"105",1,681600,477373,204227,37,0.0510291958108927,1
"109",1,484800,359431,125369,33,0.097197055416925,1
"112",0,890400,639615,250785,51,0.011894615001531,1
"113",0,543600,428439,115161,20,0.215020372739999,1
"139",0,492000,361242,130758,24,0.178206356635695,1
"148",1,1064400,706243,358157,41,0.0184657985811066,1
"175",1,1130400,809907,320493,47,0.0104526614073492,1
"178",0,441600,329949,111651,21,0.232500255150934,1
"200",0,360000,275781,84219,23,0.231624586651039,1
"207",1,474000,316221,157779,32,0.104949905870392,1
"222",1,1047600,780582,267018,47,0.0123232294178607,1
"226",0,417600,315146,102454,25,0.187508311184278,1
"232",1,1402800,1037791,365009,28,0.028302706812303,1
"240",1,544800,416153,128647,33,0.0882490007970004,1
"252",0,609600,454664,154936,22,0.170031523950687,1
"265",0,716400,506165,210235,48,0.0206283771419548,1
"276",0,1236000,854070,381930,44,0.0107533891835344,1
"287",1,512400,389305,123095,33,0.0931125178043923,1
"290",0,1279200,937167,342033,20,0.0644790801827773,1
"307",0,573600,460570,113030,21,0.193710678259626,1
"308",1,645600,477488,168112,27,0.113953138309031,1
"309",0,379200,259672,119528,22,0.237303752138662,1
"310",1,1426800,1112659,314141,46,0.0067749743493365,1
"311",1,625200,456545,168655,26,0.12608643413021,1
"319",1,580800,455104,125696,26,0.136934174906943,1
"323",0,1426800,1074991,351809,25,0.034406019711417,1
"327",0,436800,357839,78961,24,0.196067467225345,1
"358",1,409200,323994,85206,49,0.0338527566369812,1
"359",0,468000,363353,104647,23,0.198359301500139,1
"366",1,670800,473786,197014,37,0.0520960306961584,1
"369",1,858000,603650,254350,29,0.0680774256002274,1
"370",0,1063200,752880,310320,21,0.0860353531605461,1
"382",0,507600,405017,102583,21,0.213115309461556,1
"386",1,903600,689820,213780,32,0.0512437121983084,1
"392",1,742800,594751,148049,35,0.0547439361692224,1
"398",0,375600,283703,91897,23,0.226256210177257,1
"400",0,412800,319144,93656,24,0.201829325178871,1
"411",0,478800,409118,69682,20,0.238095701117784,1
"424",0,385200,276702,108498,26,0.183714335703165,1
"443",0,504000,376986,127014,24,0.175365097303983,1
"445",1,1422000,1103344,318656,49,0.00538117099911395,1
"446",0,1358400,1053425,304975,26,0.0364273560977396,1
"460",0,634800,509779,125021,43,0.0360589131601992,1
"477",0,463200,356932,106268,24,0.187206584863615,1
"500",0,559200,383438,175762,23,0.170103391453868,1
"503",1,1142400,885111,257289,25,0.0574158438178317,1
"519",0,490800,392982,97818,22,0.205160821789234,1
"523",0,567600,409877,157723,22,0.180504450945118,1
"535",0,445200,324934,120266,20,0.245165322141133,1
"545",0,484800,352235,132565,21,0.217835364362494,1
"549",0,724800,597239,127561,35,0.0568379358732359,1
"550",0,462000,314245,147755,20,0.237755136175843,1
"555",0,717600,554620,162980,52,0.0153500454395655,1
"557",1,440400,328598,111802,32,0.112437088553426,1
"562",0,373200,279801,93399,21,0.255958259027904,1
"565",0,416400,310093,106307,25,0.187593208084905,1
"572",0,1423200,1121723,301477,34,0.0175842590357337,1
"574",1,908400,661985,246415,28,0.0677179842231407,1
"585",0,414000,306826,107174,26,0.176344664881351,1
"593",1,1225200,896093,329107,32,0.0285179421155477,1
"595",0,387600,303879,83721,23,0.223164626483979,1
"598",0,390000,269010,120990,55,0.0216964792430403,1
"624",0,523200,412726,110474,44,0.0405450729498071,1
"630",0,366000,265149,100851,48,0.0390741413065886,1
"634",1,1276800,973092,303708,44,0.0103349520365827,1
"635",1,1110000,849170,260830,35,0.0282667775200137,1
"645",0,402000,306586,95414,27,0.168679692040979,1
"653",0,490800,331050,159750,22,0.201139869444523,1
"658",0,435600,340852,94748,24,0.195401674805239,1
"664",1,1189200,868992,320208,29,0.038297758934129,1
"669",0,474000,369873,104127,20,0.237116564402228,1
"681",0,488400,337292,151108,22,0.202375319980208,1
"683",1,837600,638130,199470,48,0.0168190627765257,1
"686",0,582000,430294,151706,47,0.0286970827272879,1
"689",1,709200,522678,186522,27,0.102495438336311,1
"708",1,1305600,994798,310802,28,0.0340908247704208,1
"709",1,1207200,861924,345276,35,0.0231674323310673,1
"714",0,729600,514185,215415,31,0.0734470857891599,1
"723",1,976800,761710,215090,29,0.0568393919654399,1
"742",0,994800,738408,256392,40,0.0234080059025817,1
"745",0,424800,345618,79182,21,0.240162486749926,1
"751",1,1148400,896032,252368,46,0.0112601483252722,1
"754",0,547200,378606,168594,21,0.197481949424666,1
"761",0,618000,442414,175586,34,0.0716425158572737,1
"771",0,818400,576017,242383,46,0.0199775936833071,1
"779",0,662400,485492,176908,43,0.0337303509835891,1
"797",0,421200,332550,88650,20,0.255434451632169,1
"799",1,1180800,988517,192283,46,0.0109021791276079,1
"835",0,1437600,1071171,366429,39,0.0113008724717483,1
"846",1,507600,363053,144547,42,0.0478160472340868,1
"856",0,1023600,737532,286068,38,0.025719084755046,1
"858",1,823200,610311,212889,46,0.0200446501594676,1
"862",0,432000,338873,93127,21,0.236855514733615,1
"868",0,554400,370113,184287,22,0.182356907771815,1
"872",0,514800,366938,147862,24,0.171454324564882,1
"882",1,408000,296611,111389,50,0.0310944291283616,1
"887",0,562800,443587,119213,20,0.209127863197157,1
"908",0,1036800,721318,315482,23,0.0774337852014222,1
"924",1,1038000,691018,346982,40,0.0209793238675396,1
"940",0,648000,469301,178699,20,0.181929699496801,1
"942",0,376800,303677,73123,28,0.165016858100129,1
"943",1,510000,391529,118471,33,0.0936254719307282,1
"951",0,430800,296520,134280,42,0.0545409968016705,1
"971",0,481200,340926,140274,24,0.180429374701203,1
"975",0,410400,291913,118487,22,0.227625670956887,1
"989",0,1244400,872980,371420,38,0.0170306586602624,1
"1000",0,608400,478910,129490,52,0.0187725901674369,1
"1001",1,531600,386617,144983,35,0.0774494793690996,1
"1013",1,650400,515037,135363,45,0.0299957656196001,1
"1029",0,368400,286206,82194,28,0.166549122832519,1
"1038",0,409200,311846,97354,27,0.166809929760565,1
"1061",0,487200,347502,139698,20,0.230418803902829,1
"1076",0,386400,284546,101854,27,0.172178790501785,1
"1077",0,1076400,808426,267974,47,0.0117194899357755,1
"1081",0,398400,310661,87739,27,0.169999935694702,1
"1087",0,380400,285313,95087,26,0.185791199831882,1
"1090",0,687600,486706,200894,24,0.130177778031656,1
"1095",1,678000,544098,133902,36,0.0568385400250504,1
"1097",1,1046400,779623,266777,48,0.0114176227599009,1
"1105",0,531600,468860,62740,23,0.183740802803017,1
"1144",0,363600,259245,104355,26,0.189713117575024,1
"1187",0,1190400,965971,224429,21,0.072329042217243,1
"1190",0,944400,748376,196024,41,0.0241761290822459,1
"1199",0,458400,352512,105888,23,0.200967558402879,1
"1220",0,738000,602877,135123,23,0.132174179738348,1
"1222",0,536400,397910,138490,22,0.189916308207863,1
"1234",1,711600,507246,204354,26,0.108930407829755,1
"1240",0,638400,480028,158372,21,0.173962743278335,1
"1247",0,439200,350765,88435,25,0.182648588552437,1
"1254",1,984000,744964,239036,28,0.0599860511652082,1
"1258",1,572400,411578,160822,43,0.0395094514986358,1
"1259",0,454800,389011,65789,25,0.179939862876491,1
"1266",0,675600,503529,172071,29,0.0941469037955993,1
"1268",0,368400,294073,74327,24,0.215962109753235,1
"1316",1,1137600,859007,278593,45,0.0122813816795386,1
"1345",0,495600,340016,155584,22,0.200059182108749,1
"1357",1,412800,297977,114823,45,0.0451438185402161,1
"1367",1,706800,547238,159562,48,0.0213923081156294,1
"1401",0,1088400,777647,310753,41,0.018052846465244,1
"1408",0,379200,269751,109449,23,0.223928111800072,1
"1437",0,1227600,936182,291418,35,0.0228495506540273,1
"1445",0,466800,345507,121293,23,0.197633001396273,1
"1451",0,1182000,945500,236500,25,0.0542000131563295,1
"1453",1,1267200,827179,440021,48,0.00726451937143867,1
"1460",0,403200,310017,93183,39,0.072457014507202,1
"1461",0,1129200,806795,322405,32,0.0336536806350953,1
"1466",0,360000,244344,115656,20,0.274195726776234,1
"1468",1,813600,653202,160398,41,0.0306363394184318,1
"1481",0,451200,327061,124139,21,0.228627798230715,1
"1488",0,394800,273278,121522,23,0.218386308373561,1
"1493",1,855600,623138,232462,29,0.0689057945331433,1
"1497",1,698400,530472,167928,26,0.112647797747471,1
"1513",0,691200,517248,173952,23,0.139981243596475,1
"1522",0,386400,298576,87824,22,0.237321985602804,1
"1524",0,538800,396982,141818,30,0.10991168645611,1
"1527",0,525600,411606,113994,34,0.0850888520300292,1
"1539",0,652800,474235,178565,41,0.0399252601257025,1
"1551",1,1184400,902663,281737,26,0.0492125262694326,1
"1556",0,678000,539417,138583,21,0.165309040941894,1
"1558",0,1345200,1189580,155620,45,0.00899788548250929,1
"1561",0,573600,440107,133493,21,0.192432026352013,1
"1567",1,607200,457825,149375,50,0.0218087918137,1
"1571",0,644400,473539,170861,21,0.17174355686982,1
"1576",0,404400,299558,104842,20,0.259821964942382,1
"1577",0,825600,619584,206016,21,0.129554820468619,1
"1618",0,613200,430988,182212,21,0.17898967128894,1
"1626",1,368400,272989,95411,29,0.155115590025464,1
"1630",1,949200,693875,255325,38,0.029547027223851,1
"1645",1,484800,368357,116443,26,0.15854714979553,1
"1650",0,1014000,787056,226944,34,0.0363982304354445,1
"1655",0,480000,330829,149171,24,0.180212707849124,1
"1661",1,706800,482972,223828,41,0.0358200776653845,1
"1669",0,858000,600624,257376,41,0.027354407179862,1
"1700",0,518400,405298,113102,43,0.0440596407309947,1
"1702",0,852000,570605,281395,48,0.0158849770004778,1
"1706",1,759600,543895,215705,38,0.0413405876563672,1
"1707",0,564000,443761,120239,46,0.0323504941793902,1
"1715",0,546000,398131,147869,21,0.199137735431805,1
"1746",1,1285200,819061,466139,43,0.0103306386167518,1
"1748",0,480000,362308,117692,21,0.220294612726892,1
"1752",1,902400,654376,248024,37,0.03464275563885,1
"1755",0,382800,313960,68840,26,0.18674946492611,1
"1758",0,372000,266940,105060,30,0.143729838241145,1
"1759",1,468000,307416,160584,37,0.0736978078009391,1
"1771",0,1228800,895393,333407,20,0.0702407416937954,1
"1774",1,627600,495171,132429,37,0.0573474165237112,1
"1794",0,1116000,847863,268137,42,0.016191524645566,1
"1798",1,1414800,1136150,278650,49,0.00553676442143383,1
"1804",1,574800,434569,140231,42,0.0428027588684236,1
"1805",0,662400,483278,179122,21,0.166842630778549,1
"1817",0,489600,328849,160751,24,0.177063341878755,1
"1836",1,477600,336087,141513,27,0.148557278953676,1
"1858",0,410400,310730,99670,24,0.202118311886312,1
"1864",0,1150800,899268,251532,33,0.0308804969269423,1
"1870",0,462000,352441,109559,21,0.226330129058779,1
"1872",0,518400,377549,140851,23,0.182513992330902,1
"1889",0,914400,697820,216580,52,0.0106923301940029,1
"1903",1,1046400,740247,306153,50,0.00960524509685309,1
"1910",0,1178400,915457,262943,28,0.0430256856950278,1
"1915",0,372000,283572,88428,25,0.200886765653999,1
"1939",0,468000,295371,172629,25,0.170408615291236,1
"1954",0,1051200,757952,293248,32,0.0388268761283699,1
"1961",1,708000,533112,174888,48,0.0212202881657782,1
"1964",1,690000,514782,175218,33,0.0686069201914748,1
"1976",1,735600,583912,151688,37,0.0475832873982982,1
"1992",1,637200,518000,119200,47,0.0264544238160628,1
"1994",0,6e+05,419941,180059,22,0.170985334203458,1
"2004",1,1022400,790384,232016,44,0.0165066614434727,1
"2015",1,438000,334028,103972,25,0.182032975687864,1
"2061",1,817200,616959,200241,46,0.0203530941408359,1
"2064",1,608400,415334,193066,48,0.0249861330769893,1
"2081",1,745200,558209,186991,46,0.0231464835084605,1
"2100",0,759600,540072,219528,29,0.0808962800067819,1
"2102",0,463200,341871,121329,20,0.239298353306635,1
"2118",1,1136400,779539,356861,42,0.0150936628954126,1
"2140",0,541200,446254,94946,20,0.217105912925739,1
"2146",1,402000,323660,78340,29,0.148419296908957,1
"2148",1,456000,366469,89531,47,0.036398814007165,1
"2149",1,1062000,764391,297609,42,0.0175645734976256,1
"2157",0,512400,400530,111870,23,0.185840026186267,1
"2175",0,622800,435458,187342,54,0.0153114071231234,1
"2178",1,768000,540332,227668,44,0.025584052940898,1
"2212",1,1414800,961624,453176,49,0.00516438348222709,1
"2220",0,594000,455899,138101,46,0.0305321317799805,1
"2224",1,1243200,876258,366942,48,0.00779767686965337,1
"2244",0,464400,366426,97974,54,0.0208291815114229,1
"2246",0,441600,351150,90450,21,0.234021067864602,1
"2254",0,546000,406094,139906,44,0.0385790294512951,1
"2268",0,416400,300563,115837,60,0.0140625580167376,1
"2273",0,519600,390973,128627,20,0.221270887211075,1
"2275",0,368400,277680,90720,25,0.201753147227683,1
"2278",0,672000,533446,138554,20,0.178099504481606,1
"2280",0,481200,369735,111465,25,0.170607186270373,1
"2282",1,1282800,923675,359125,44,0.0100054028018758,1
"2288",0,495600,349342,146258,23,0.188218493258707,1
"2290",0,613200,429132,184068,22,0.167507555043705,1
"2296",0,654000,438480,215520,32,0.0771344836846621,1
"2308",1,684000,477750,206250,36,0.054756171945904,1
"2336",0,448800,351838,96962,20,0.245728193627651,1
"2337",1,1078800,796512,282288,39,0.0216871449574682,1
"2340",1,1353600,1063178,290422,38,0.0145658115915679,1
"2355",0,655200,477340,177860,37,0.0538525123030961,1
"2383",1,612000,455181,156819,28,0.112343238252858,1
"2386",0,489600,335685,153915,25,0.166162319856077,1
"2400",0,465600,349878,115722,21,0.224796506260973,1
"2412",0,513600,366153,147447,20,0.221782081170724,1
"2419",1,1298400,900077,398323,26,0.0388791524895368,1
"2431",0,490800,358139,132661,20,0.229801376440924,1
"2436",0,1018800,739462,279338,22,0.0868864743605918,1
"2443",0,441600,366795,74805,21,0.235147753386168,1
"2448",0,500400,397677,102723,22,0.202114121681529,1
"2450",1,579600,438262,141338,48,0.0267808248204486,1
"2460",1,1141200,886947,254253,39,0.0197008403797944,1
"2475",1,1099200,765819,333381,45,0.0128432910033893,1
"2491",0,535200,410506,124694,21,0.203676176743032,1
"2492",0,871200,685489,185711,24,0.0984130096809574,1
"2498",1,529200,407463,121737,46,0.0342946822454754,1
"2501",0,693600,551705,141895,60,0.00860977356250862,1
"2504",1,1002000,644515,357485,48,0.0118946339426932,1
"2507",0,829200,595801,233399,50,0.0143994908721177,1
"2511",0,885600,645305,240295,34,0.0449358197073803,1
"2513",0,1236000,978883,257117,46,0.00965526214827499,1
"2520",0,982800,798549,184251,49,0.0121761577922182,1
"2551",0,1357200,1070010,287190,45,0.00836314522809419,1
"2552",1,1016400,786185,230215,34,0.0362052256570603,1
"2559",0,532800,352773,180027,22,0.188328764715387,1
"2573",0,517200,421833,95367,24,0.1738612185838,1
"2590",0,1227600,864950,362650,47,0.00868355053081199,1
"2602",1,1368000,1009613,358387,31,0.0238742956494415,1
"2605",0,642000,492263,149737,21,0.173554407665775,1
"2608",0,416400,309854,106546,26,0.175771214050122,1
"2622",0,384000,275589,108411,47,0.0407943226935635,1
"2627",1,1287600,979988,307612,38,0.0162119589656467,1
"2630",0,540000,375395,164605,30,0.108816688914435,1
"2642",0,457200,335534,121666,22,0.213318001438608,1
"2665",0,490800,354823,135977,58,0.0143489784925295,1
"2666",0,504000,365626,138374,23,0.186459257872333,1
"2681",0,1014000,747283,266717,52,0.0088180558941785,1
"2684",1,891600,671253,220347,48,0.0151981473520947,1
"2699",0,805200,653938,151262,31,0.0665065141034886,1
"2712",1,1026000,758129,267871,49,0.0109300019631372,1
"2714",0,1172400,816836,355564,54,0.00551830304091183,1
"2717",0,463200,331757,131443,24,0.185675042677086,1
"2740",1,1150800,934151,216649,48,0.00971879117835682,1
"2742",1,382800,285953,96847,30,0.141817091820087,1
"2767",0,471600,331785,139815,21,0.221300138575638,1
"2779",0,406800,271997,134803,25,0.188416185595543,1
"2783",0,414000,313863,100137,23,0.21413838344798,1
"2785",1,529200,393511,135689,41,0.0499142453687028,1
"2806",0,1008000,757644,250356,48,0.0122821847442296,1
"2819",0,514800,382485,132315,23,0.183970397653673,1
"2833",0,454800,348669,106131,20,0.243107617333525,1
"2847",0,1032000,841247,190753,27,0.0608208073873902,1
"2850",0,760800,578688,182112,42,0.0307660289185873,1
"2862",0,438000,327112,110888,25,0.181620318851411,1
"2866",1,1315200,1104774,210426,50,0.00625335478680779,1
"2869",0,392400,317123,75277,21,0.250968299228242,1
"2890",0,658800,483707,175093,21,0.167946956636471,1
"2891",0,517200,392415,124785,24,0.172173005730644,1
"2909",0,976800,751676,225124,36,0.0332740477954813,1
"2926",1,792000,577000,215000,29,0.0769034536469674,1
"2927",0,535200,406974,128226,21,0.203446509187051,1
"2956",0,990000,733846,256154,47,0.0136726445298272,1
"2996",1,1360800,1087314,273486,39,0.0133912592839267,1
"2998",1,1227600,927284,300316,28,0.0390465253127504,1
"3009",0,1324800,996880,327920,29,0.0303543395701137,1
"3010",0,891600,707045,184555,48,0.0154145100461282,1
"3038",0,778800,635054,143746,57,0.00939721445791553,1
"3054",0,426000,322147,103853,20,0.252685069320582,1
"3062",1,363600,281362,82238,35,0.103586208382352,1
"3063",0,694800,522515,172285,25,0.121321810926004,1
"3066",0,1258800,972893,285907,29,0.0345061516423098,1
"3069",1,1034400,812791,221609,47,0.0128366764626425,1
"3123",0,412800,344704,68096,23,0.216665566579638,1
"3140",0,645600,462780,182820,20,0.182309852838304,1
"3146",1,631200,446417,184783,47,0.0260507483842316,1
"3151",0,378000,258122,119878,21,0.252350925527566,1
"3156",1,968400,686867,281533,44,0.0177651143202649,1
"3161",1,520800,383336,137464,28,0.130168243346807,1
"3163",1,1147200,809764,337436,28,0.0440579505012956,1
"3167",1,1096800,839249,257551,46,0.0122872234271243,1
"3171",0,974400,736366,238034,51,0.0103356609040604,1
"3175",1,1225200,951898,273302,48,0.00835084820800764,1
"3177",0,566400,390226,176174,24,0.157477371996,1
"3198",1,380400,304353,76047,37,0.0875568490927832,1
"3207",0,500400,398144,102256,45,0.0391600467566663,1
"3209",0,471600,345291,126309,24,0.183768692953259,1
"3219",0,1231200,824040,407160,20,0.0680660684093019,1
"3223",1,699600,523158,176442,36,0.0539657004085968,1
"3236",0,573600,451146,122454,41,0.0465868202834504,1
"3249",1,1303200,1060159,243041,40,0.0138437182372765,1
"3273",0,508800,392988,115812,22,0.198913248899266,1
"3276",0,576000,420214,155786,23,0.167100443421736,1
"3282",0,483600,358048,125552,25,0.169217215605159,1
"3294",0,943200,646688,296512,47,0.0145891609573735,1
"3345",1,709200,498999,210201,33,0.0656226610152046,1
"3354",1,1341600,986202,355398,40,0.0123908583727976,1
"3361",1,885600,604850,280750,50,0.0128197185709371,1
"3365",0,423600,337962,85638,24,0.199310895771137,1
"3366",0,574800,403079,171721,22,0.177823594090798,1
"3371",0,364800,288452,76348,27,0.179139478053908,1
"3385",0,531600,369265,162335,24,0.166506000247933,1
"3396",1,784800,584362,200438,49,0.0170300123108686,1
"3403",1,666000,494799,171201,25,0.126852788812284,1
"3425",1,735600,589324,146276,26,0.1071231328221,1
"3432",0,429600,308121,121479,25,0.18318167951148,1
"3434",0,1064400,852351,212049,54,0.0070520240260491,1
"3438",0,825600,613705,211895,31,0.0628733765849774,1
"3459",0,495600,378052,117548,21,0.215645484158117,1
"3473",1,578400,413753,164647,30,0.102460215633375,1
"3477",0,422400,329035,93365,24,0.199151895302467,1
"3492",1,1110000,847056,262944,39,0.0207139417477683,1
"3503",1,1198800,932341,266459,40,0.0164239121935407,1
"3504",0,414000,308214,105786,33,0.109402295161458,1
"3513",0,536400,385792,150608,21,0.201656908070349,1
"3514",1,619200,466743,152457,27,0.119365944608193,1
"3515",1,852000,664665,187335,45,0.0208299748194095,1
"3529",0,829200,612986,216214,43,0.0250122352987404,1
"3538",0,361200,271453,89747,25,0.203855771357675,1
"3557",0,1262400,918111,344289,31,0.028745342658078,1
"3563",0,676800,534420,142380,20,0.176648469175816,1
"3574",0,1096800,872346,224454,44,0.0145620115080924,1
"3578",0,841200,647678,193522,36,0.042335246411875,1
"3585",1,882000,652985,229015,41,0.0265499810536002,1
"3606",0,591600,428883,162717,46,0.0303648064109909,1
"3607",0,427200,291200,136000,23,0.20789350296655,1
"3618",0,444000,312973,131027,26,0.167501141275733,1
"3620",0,417600,346750,70850,24,0.201948071938858,1
"3621",0,625200,454810,170390,20,0.188460059954558,1
"3637",0,477600,384175,93425,40,0.0595555798813527,1
"3644",0,730800,527796,203004,34,0.0589469439510658,1
"3650",0,627600,508992,118608,21,0.179030835103037,1
"3656",0,778800,540530,238270,52,0.0134055065974415,1
"3676",0,543600,384014,159586,22,0.186694931546489,1
"3682",0,804000,651423,152577,48,0.018152960672282,1
"3687",0,457200,351223,105977,25,0.176960357632495,1
"3693",0,529200,395701,133499,43,0.0429320877828554,1
"3704",0,442800,349668,93132,32,0.112765145880923,1
"3711",0,1046400,730250,316150,38,0.024447416654103,1
"3740",0,909600,690889,218711,57,0.0072668295904242,1
"3751",1,1215600,902202,313398,35,0.0231237502827028,1
"3792",0,469200,369346,99854,22,0.211265037368132,1
"3814",0,476400,390371,86029,24,0.18493333864599,1
"3816",0,422400,325882,96518,23,0.211914385910011,1
"3819",1,849600,585176,264424,27,0.0796553127565101,1
"3821",1,460800,322918,137882,41,0.0558675988334563,1
"3824",1,1274400,982103,292297,36,0.0195027636476558,1
"3828",1,1424400,1099912,324488,32,0.0203232955427865,1
"3830",0,542400,443982,98418,56,0.0155797587653942,1
"3831",0,609600,434126,175474,33,0.0781666094581044,1
"3838",0,535200,437761,97439,20,0.218727145909163,1
"3851",0,582000,416591,165409,22,0.176354149968251,1
"3865",0,394800,264366,130434,21,0.246051704456937,1
"3872",1,1254000,1076574,177426,27,0.0422616303778923,1
"3878",0,487200,406148,81052,59,0.0136438259790677,1
"3880",0,385200,278842,106358,27,0.172220991947452,1
"3890",0,650400,514135,136265,46,0.0277588359135808,1
"3895",0,1046400,726075,320325,28,0.0524650277848899,1
"3906",0,370800,285218,85582,23,0.228177657621377,1
"3909",1,1378800,1009445,369355,33,0.0199769281098527,1
"3915",1,1264800,902309,362491,37,0.0178405339252111,1
"3919",0,871200,617510,253690,39,0.0312525177159671,1
"3932",0,427200,322342,104858,58,0.0162111995168003,1
"3955",1,691200,521360,169840,41,0.0375509269524732,1
"3964",0,627600,464768,162832,22,0.165189897445099,1
"3973",0,1273200,945860,327340,31,0.0284087583427236,1
"3977",0,1076400,842069,234331,21,0.0866150681465771,1
"3978",1,993600,746120,247480,48,0.0126064077616777,1
"3981",0,1002000,768370,233630,26,0.0677191693207658,1
"3998",0,420000,295876,124124,21,0.238412234201425,1
"4017",1,997200,738499,258701,46,0.0145890979492252,1
"4027",1,505200,346083,159117,43,0.0442568371969229,1
"4045",0,474000,305586,168414,22,0.205343616900551,1
"4049",0,620400,474911,145489,20,0.191289946899358,1
"4051",1,1004400,746110,258290,42,0.0196957587652427,1
"4055",0,554400,429134,125266,21,0.198237874654802,1
"4056",1,1144800,937926,206874,39,0.0199475205730573,1
"4059",0,1143600,863879,279721,35,0.0264977205811818,1
"4070",1,1383600,1049214,334386,29,0.0273952536774095,1
"4079",0,367200,296502,70698,53,0.0268659125007248,1
"4086",1,378000,243488,134512,30,0.141004033327867,1
"4089",0,1299600,912240,387360,30,0.028661444820155,1
"4096",0,622800,483913,138887,54,0.0156071950440935,1
"4097",1,1114800,834311,280489,36,0.0257525233246262,1
"4109",0,403200,324728,78472,21,0.247189406247585,1
"4122",0,381600,287326,94274,27,0.173816964903758,1
"4127",0,6e+05,422741,177259,21,0.182710068391789,1
"4143",0,604800,461891,142909,20,0.195716820260029,1
"4153",0,655200,488078,167122,21,0.169279327097989,1
"4155",0,998400,795531,202869,26,0.0689058312624845,1
"4160",1,1390800,999188,391612,49,0.00551886280394209,1
"4167",0,410400,330961,79439,24,0.203430032890644,1
"4176",0,1374000,977503,396497,27,0.0317126892768149,1
"4183",1,927600,688628,238972,34,0.0419026301115353,1
"4214",0,1228800,924251,304549,34,0.0245153592694328,1
"4222",0,1276800,1002448,274352,24,0.0492104420784176,1
"4241",0,394800,295359,99441,23,0.219901785241664,1
"4242",1,549600,418005,131595,44,0.0384688664528885,1
"4256",0,825600,578719,246881,39,0.0338533594215082,1
"4260",0,439200,351419,87781,23,0.207616083199252,1
"4281",1,1016400,819799,196601,28,0.0577835542606133,1
"4282",0,850800,627693,223107,34,0.0479400608057212,1
"4290",0,657600,518162,139438,30,0.0912192226324339,1
"4293",1,744000,544805,199195,50,0.0169055887021828,1
"4302",0,1197600,844482,353118,36,0.0217247996425377,1
"4306",0,369600,313512,56088,25,0.203658217056229,1
"4311",0,627600,490897,136703,20,0.18988749828672,1
"4319",1,1375200,1071308,303892,50,0.00542672745900643,1
"4327",0,772800,570335,202465,24,0.114123463690591,1
"4329",0,1228800,980784,248016,23,0.0580263749400059,1
"4337",1,1135200,803540,331660,49,0.00881743863270418,1
"4338",0,634800,480461,154339,20,0.186877278621446,1
"4342",1,507600,393867,113733,33,0.0941448578360636,1
"4346",0,1006800,724773,282027,28,0.0568411945537773,1
"4348",0,1072800,779882,292918,41,0.0186744475600874,1
"4361",0,442800,343718,99082,25,0.181074738435482,1
"4364",0,505200,379380,125820,23,0.186904526193769,1
"4370",0,664800,511432,153368,46,0.0269057851500076,1
"4382",1,423600,315237,108363,26,0.173846367458738,1
"4385",1,816000,581613,234387,48,0.0172178739358386,1
"4392",1,662400,498963,163437,25,0.127900003685492,1
"4414",0,391200,282786,108414,26,0.182148089629641,1
"4461",1,408000,305486,102514,50,0.0312018500284022,1
"4466",0,590400,438895,151505,21,0.186799208772693,1
"4474",0,384000,292193,91807,26,0.185037228270727,1
"4478",1,1328400,1044965,283435,25,0.0416991142496362,1
"4480",0,456000,353749,102251,25,0.177484844763544,1
"4498",0,855600,666622,188978,42,0.0261108210932959,1
"4501",1,1138800,759067,379733,32,0.0323826749241931,1
"4514",0,519600,360904,158696,21,0.205906448371381,1
"4516",1,1062000,764472,297528,36,0.0279917100779364,1
"4537",0,1338000,1084366,253634,39,0.0140392267238233,1
"4539",0,1389600,954719,434881,29,0.0260732258511062,1
"4543",0,973200,835624,137576,51,0.0107784297473955,1
"4560",1,768000,599141,168859,35,0.0520898988129751,1
"4565",0,478800,342233,136567,25,0.169779187762807,1
"4571",0,903600,657175,246425,24,0.0914462473360581,1
"4576",1,1281600,978104,303496,30,0.0305327071284312,1
"4577",0,1210800,944338,266462,33,0.0277230319656017,1
"4588",0,1344000,1046127,297873,33,0.0218095797562955,1
"4590",1,648000,490629,157371,39,0.0472363132863905,1
"4592",0,850800,577416,273384,24,0.0984643860561491,1
"4593",0,1324800,989165,335635,33,0.0222076534514103,1
"4598",0,375600,286782,88818,22,0.240691130384855,1
"4606",0,445200,356652,88548,22,0.219131985249147,1
"4611",0,1096800,787460,309340,27,0.0522439400488195,1
"4613",0,602400,489245,113155,21,0.185943407836676,1
"4614",1,1256400,941326,315074,28,0.0369851736281065,1
"4616",0,669600,503710,165890,46,0.0265563258385197,1
"4619",0,430800,315263,115537,22,0.22160692062995,1
"4623",0,1321200,983731,337469,47,0.00745416579971299,1
"4630",0,1430400,1073148,357252,31,0.0214643306521815,1
"4636",1,1042800,790797,252003,41,0.0199812973653967,1
"4639",0,428400,298970,129430,59,0.014816150002165,1
"4671",0,426000,321514,104486,25,0.185153409886078,1
"4675",0,534000,354900,179100,22,0.188064348213489,1
"4684",0,493200,363423,129777,23,0.189876553617537,1
"4696",0,579600,442152,137448,22,0.178605093824041,1
"4703",1,484800,378275,106525,41,0.0543331644978525,1
"4708",0,586800,440454,146346,21,0.18807501770274,1
"4711",0,553200,421467,131733,21,0.198159804280876,1
"4717",0,704400,519172,185228,20,0.167316700796381,1
"4722",0,548400,434516,113884,24,0.165122460351525,1
"4731",0,494400,388257,106143,20,0.230568348432909,1
"4732",0,882000,690685,191315,45,0.0197535361341217,1
"4771",0,411600,317215,94385,44,0.0491741017284767,1
"4783",0,577200,422062,155138,33,0.0829748332508358,1
"4790",1,747600,533739,213861,42,0.0310774829386157,1
"4797",0,484800,364059,120741,37,0.0727845340545221,1
"4807",1,9e+05,735634,164366,49,0.0141613626626924,1
"4819",0,415200,295837,119363,21,0.240291041215617,1
"4820",1,981600,809758,171842,37,0.0312005857715432,1
"4822",0,421200,282719,138481,24,0.196613492696918,1
"4823",0,430800,327497,103303,25,0.183959143806538,1
"4825",1,548400,422371,126029,30,0.108889873319938,1
"4834",0,579600,385754,193846,45,0.0330651262759779,1
"4839",1,631200,470574,160626,42,0.0386272095993562,1
"4841",1,759600,575089,184511,36,0.0486934237884491,1
"4849",0,380400,274801,105599,36,0.0931094131374207,1
"4857",0,379200,244819,134381,32,0.122613216557538,1
"4858",0,1305600,980742,324858,21,0.0576724564042034,1
"4865",0,366000,306738,59262,28,0.168417869765797,1
"4875",0,532800,392764,140036,21,0.203360354064742,1
"4878",0,432000,318078,113922,39,0.0686046128159286,1
"4891",0,1003200,804823,198377,29,0.0547558455114859,1
"4910",1,490800,362395,128405,39,0.0619685573497741,1
"4914",1,1340400,931302,409098,32,0.0227047656508578,1
"4925",0,687600,469117,218483,20,0.169571436549284,1
"4931",1,1132800,822798,310002,31,0.0362885693533219,1
"4942",0,423600,311967,111633,22,0.224062746481839,1
"4946",0,1005600,737765,267835,34,0.0363392498173776,1
"4947",1,1290000,995263,294737,49,0.00683674644882907,1
"4948",0,422400,316369,106031,20,0.25371257927243,1
"4950",0,362400,276889,85511,24,0.216984347901017,1
"4952",1,464400,331997,132403,30,0.123736647497195,1
"4965",1,964800,765456,199344,47,0.0146053696426059,1
"4989",1,1282800,997394,285406,31,0.0284087239705514,1
"4995",0,417600,305760,111840,24,0.199311452024901,1
"4998",0,442800,302510,140290,23,0.203149765861642,1
"5008",0,484800,341207,143593,23,0.191292102648122,1
"5014",0,1184400,1008854,175546,41,0.0161396223856495,1
"5017",0,538800,361566,177234,22,0.186897237604737,1
"5027",0,372000,263118,108882,27,0.175396671262221,1
"5041",1,556800,421860,134940,29,0.114967087579016,1
"5078",0,716400,572599,143801,20,0.166703244068026,1
"5091",1,728400,533555,194845,37,0.0473709965322594,1
"5109",0,570000,466046,103954,23,0.17150241439707,1
"5127",0,556800,360818,195982,23,0.169552866616713,1
"5129",0,1016400,714534,301866,42,0.0189659423664302,1
"5130",1,410400,320794,89606,38,0.0771808147316805,1
"5136",0,988800,812348,176452,29,0.0565437552200331,1
"5142",0,591600,477575,114025,45,0.0334182876101244,1
"5158",0,579600,422989,156611,49,0.0246386283000764,1
"5161",0,847200,546852,300348,25,0.0912592493940895,1
"5168",0,1434000,1024296,409704,30,0.0225863095086678,1
"5169",0,788400,573007,215393,40,0.033799877657321,1
"5172",0,568800,437928,130872,36,0.0680853974639011,1
"5177",1,1252800,994873,257927,32,0.0279742353693481,1
"5191",1,1011600,764449,247151,28,0.0571409731039145,1
"5206",0,744000,553386,190614,28,0.0901456478018838,1
"5224",1,895200,635667,259533,49,0.0137518463143889,1
"5236",1,1070400,803240,267160,34,0.0325745783211801,1
"5240",0,1212000,915063,296937,45,0.01071829550901,1
"5254",0,465600,359720,105880,20,0.239661018501163,1
"5260",0,508800,378214,130586,23,0.185658671933621,1
"5261",1,633600,453800,179800,30,0.0933859202107104,1
"5272",1,835200,656607,178593,33,0.0539597677684306,1
"5277",1,9e+05,630957,269043,28,0.0680750452859936,1
"5299",1,777600,528677,248923,31,0.0670792145301958,1
"5309",0,720000,576103,143897,20,0.165823555845084,1
"5315",1,672000,469240,202760,35,0.0602741892841847,1
"5328",1,435600,332206,103394,40,0.0635747820191267,1
"5330",0,943200,718862,224338,40,0.0258885146857381,1
"5342",0,655200,509584,145616,20,0.182027030041228,1
"5351",1,829200,561798,267402,35,0.0453021367625156,1
"5361",1,1395600,937578,458022,28,0.0276315259627313,1
"5368",0,1130400,839720,290680,54,0.00609277962528923,1
"5381",1,1177200,883169,294031,27,0.0459614165664112,1
"5394",1,1108800,760802,347998,42,0.0158851348110856,1
"5395",0,748800,524263,224537,30,0.0763672087529332,1
"5402",0,668400,445640,222760,20,0.174114539279815,1
"5440",0,608400,454868,153532,22,0.170408031478829,1
"5446",0,450000,338386,111614,21,0.229886957491852,1
"5456",0,496800,375636,121164,22,0.201938599717467,1
"5458",1,562800,392029,170771,25,0.148288538603678,1
"5469",1,1105200,844102,261098,40,0.0193350749188493,1
"5478",0,574800,406537,168263,20,0.202476312729494,1
"5479",0,481200,347217,133983,24,0.180802792285694,1
"5487",0,680400,531405,148995,53,0.015219754596288,1
"5489",0,384000,291986,92014,23,0.223681914378543,1
"5496",1,1375200,1075838,299362,36,0.0163515024961155,1
"5508",0,633600,478416,155184,21,0.175359410166898,1
"5519",0,1255200,913151,342049,50,0.0065871230295712,1
"5530",1,970800,723852,246948,30,0.0526144320441872,1
"5535",1,777600,543030,234570,25,0.104328684209669,1
"5557",1,1395600,1020486,375114,40,0.0111970018320176,1
"5566",0,798000,659077,138923,29,0.0783353369678784,1
"5584",1,1375200,1009690,365510,43,0.00919748301446439,1
"5590",1,763200,535518,227682,47,0.0204362772343539,1
"5592",1,397200,290446,106754,31,0.129101498131266,1
"5596",1,1178400,852782,325618,39,0.0179685969773588,1
"5607",0,512400,379264,133136,48,0.0301226429349341,1
"5626",0,434400,298036,136364,21,0.232982975682997,1
"5641",1,579600,434704,144896,33,0.0829674397152045,1
"5654",1,1028400,788972,239428,44,0.0162891583235476,1
"5672",1,658800,448479,210321,32,0.0766854527378142,1
"5687",0,498000,337405,160595,32,0.100962430714249,1
"5696",1,1380000,1110339,269661,27,0.0329756863107751,1
"5712",0,1093200,873396,219804,36,0.027359576440867,1
"5717",0,366000,269646,96354,22,0.243221779959905,1
"5754",1,1041600,760817,280783,50,0.00978366955531659,1
"5775",0,444000,348385,95615,21,0.232897830507215,1
"5778",0,811200,614146,197054,48,0.0176180572220484,1
"5779",0,483600,356460,127140,21,0.218565207904964,1
"5800",0,416400,308338,108062,22,0.226514465753656,1
"5828",0,590400,472041,118359,23,0.165683020543073,1
"5830",0,1431600,1048093,383507,25,0.0337111092916748,1
"5833",1,969600,698058,271542,34,0.0385586855738985,1
"5843",0,470400,356747,113653,20,0.237566713032667,1
"5847",1,625200,488873,136327,27,0.11894158981842,1
"5852",0,447600,329916,117684,20,0.244579260296409,1
"5857",0,1297200,1008024,289176,39,0.0148538513904451,1
"5858",1,631200,492047,139153,36,0.0612761456896377,1
"5864",1,843600,590840,252760,34,0.0479730192807813,1
"5883",0,896400,638288,258112,26,0.0796536338771415,1
"5904",0,480000,371866,108134,48,0.0321365601938916,1
"5916",0,1317600,981280,336320,21,0.0562956537202306,1
"5936",0,574800,433956,140844,35,0.0723226328540033,1
"5941",0,840000,639339,200661,59,0.0070556658450448,1
"5946",1,1196400,840134,356266,46,0.00994260714019075,1
"5955",1,591600,418220,173380,32,0.0866137238650588,1
"5965",0,534000,417839,116161,22,0.191949333379789,1
"5966",0,408000,316588,91412,21,0.244667326229945,1
"5973",1,562800,414300,148500,30,0.10561141469187,1
"5980",0,420000,328797,91203,23,0.212974602199051,1
"5991",1,979200,694345,284855,41,0.0219989124179202,1
"6012",0,612000,450781,161219,22,0.169084587943788,1
"6027",0,513600,362992,150608,21,0.208164865840261,1
"6030",0,519600,392534,127066,21,0.207988491222613,1
"6051",0,633600,491943,141657,20,0.18797213984773,1
"6053",1,528000,363218,164782,33,0.0894586885903209,1
"6057",0,1270800,969555,301245,27,0.0391735633373548,1
"6060",0,477600,392099,85501,23,0.196909761500063,1
"6090",0,368400,279455,88945,25,0.20186782505255,1
"6101",1,408000,314062,93938,38,0.0773567473150594,1
"6102",0,1158000,805308,352692,30,0.036929340477193,1
"6108",0,387600,294882,92718,26,0.184033073513736,1
"6109",0,520800,400194,120606,20,0.221462994523686,1
"6113",0,507600,358600,149000,59,0.0128215201936057,1
"6115",0,363600,260224,103376,24,0.215413856268563,1
"6119",0,571200,455624,115576,21,0.19420844444183,1
"6122",0,680400,500640,179760,33,0.0695715439551627,1
"6124",0,362400,257005,105395,25,0.20249930627217,1
"6140",1,1230000,973402,256598,41,0.0144484998543911,1
"6148",0,454800,339789,115011,21,0.228161405356001,1
"6159",0,378000,286642,91358,24,0.211984379807465,1
"6175",0,874800,669103,205697,51,0.0124404083179249,1
"6178",0,1227600,912782,314818,27,0.0419048761653645,1
"6184",1,402000,302364,99636,26,0.179864876458917,1
"6188",0,487200,373501,113699,22,0.205150711434872,1
"6196",1,1188000,916098,271902,37,0.0210952595698984,1
"6226",1,897600,621032,276568,39,0.0296171998945482,1
"6236",0,580800,437048,143752,51,0.0211585624940814,1
"6240",0,638400,476124,162276,49,0.022230948682654,1
"6246",0,486000,381351,104649,22,0.206087021802322,1
"6267",0,528000,383975,144025,21,0.204465863230839,1
"6273",0,562800,446235,116565,20,0.209303575290302,1
"6274",0,572400,448673,123727,21,0.193369195737219,1
"6285",0,506400,362914,143486,22,0.197816919130365,1
"6288",0,751200,586094,165106,48,0.0197797968769771,1
"6292",0,456000,330478,125522,40,0.0609697014639764,1
"6296",1,1165200,884814,280386,27,0.0471374027322525,1
"6305",0,440400,346182,94218,25,0.181989367913432,1
"6319",0,447600,347234,100366,34,0.096825857194844,1
"6332",1,916800,768598,148202,49,0.0138444787291025,1
"6335",1,1155600,918235,237365,47,0.0103414196283848,1
"6348",0,518400,392327,126073,24,0.171800025868363,1
"6352",1,838800,613779,225021,41,0.0286224214769469,1
"6360",1,612000,449241,162759,41,0.0430175523384961,1
"6361",0,511200,382144,129056,20,0.223787393028472,1
"6364",1,1208400,1039805,168595,39,0.0181533184229509,1
"6396",1,574800,421909,152891,34,0.0774910234950996,1
"6399",0,661200,452791,208409,21,0.165506369983449,1
"6402",0,426000,331258,94742,22,0.224509812251643,1
"6421",0,952800,727827,224973,34,0.0403824715474257,1
"6428",0,1048800,801778,247022,30,0.0462028700113652,1
"6433",0,406800,298933,107867,22,0.229488828889205,1
"6434",0,526800,365339,161461,24,0.16772536887629,1
"6439",1,546000,434162,111838,31,0.102322809326939,1
"6445",0,914400,698508,215892,42,0.0233674656518273,1
"6473",1,1129200,844284,284916,28,0.0463273068985223,1
"6487",1,421200,327529,93671,49,0.0330630756492238,1
"6490",0,1300800,965989,334811,27,0.0367626561245625,1
"6506",0,1272000,974490,297510,22,0.0571527023850342,1
"6522",0,1401600,992792,408808,40,0.0109340886857029,1
"6527",0,1228800,939865,288935,20,0.0714145790914188,1
"6553",0,819600,619528,200072,23,0.113962336289472,1
"6556",1,1050000,769615,280385,38,0.0246398333739544,1
"6559",1,1368000,1093286,274714,43,0.00965522636761471,1
"6560",0,375600,281888,93712,27,0.175364396383565,1
"6568",1,1162800,812385,350415,40,0.0169056998507773,1
"6593",1,933600,724035,209565,27,0.0709482997717821,1
"6605",1,1388400,1060012,328388,39,0.0124925770485048,1
"6606",0,475200,350782,124418,22,0.207891571950311,1
"6612",0,471600,364640,106960,24,0.184935608927522,1
"6623",0,366000,262101,103899,22,0.242665204549577,1
"6631",0,780000,566822,213178,53,0.0124922504754671,1
"6670",0,391200,318720,72480,27,0.172659838289093,1
"6672",1,888000,684356,203644,50,0.013162318029254,1
"6678",1,1137600,891329,246271,29,0.042973372592674,1
"6688",1,700800,563433,137367,25,0.121694595851743,1
"6700",0,1113600,852172,261428,21,0.0807849249386679,1
"6703",1,894000,679133,214867,45,0.0191720618654812,1
"6717",0,646800,467193,179607,21,0.170649192753845,1
"6721",0,426000,371706,54294,22,0.227346919749054,1
"6725",0,1046400,737490,308910,30,0.045302768869229,1
"6729",1,656400,522208,134192,40,0.043560421391374,1
"6741",0,1400400,1025840,374560,36,0.0151982187338775,1
"6763",0,910800,689197,221603,37,0.0345052129901915,1
"6766",0,388800,294409,94391,21,0.250712974006188,1
"6767",0,397200,303516,93684,22,0.233493107650649,1
"6768",1,636000,511590,124410,38,0.0526244337556848,1
"6772",0,456000,340835,115165,24,0.188587030002248,1
"6775",0,447600,354709,92891,25,0.180197506224927,1
"6776",1,1131600,804040,327560,34,0.028677105862786,1
"6794",0,1123200,923171,200029,28,0.0483362552704248,1
"6800",0,386400,299561,86839,27,0.173038852606358,1
"6802",0,584400,472208,112192,34,0.0774555323791344,1
"6809",0,1269600,900193,369407,52,0.00542595811777942,1
"6814",0,594000,448361,145639,20,0.198538343377148,1
"6824",0,403200,327115,76085,21,0.247367604910889,1
"6839",1,573600,472029,101571,50,0.0235373445193946,1
"6842",0,432000,288948,143052,50,0.0294866294936521,1
"6843",0,904800,668508,236292,24,0.0916093576125089,1
"6851",0,459600,310960,148640,21,0.224328056193507,1
"6859",0,364800,300949,63851,21,0.261050828302847,1
"6862",0,547200,409071,138129,20,0.212412463926584,1
"6864",0,579600,442205,137395,38,0.0574916678327891,1
"6867",1,1309200,1013317,295883,41,0.0124054855298282,1
"6890",0,540000,404163,135837,42,0.0454480769078693,1
"6892",1,825600,629568,196032,29,0.0733423578410324,1
"6896",0,1366800,1053612,313188,38,0.0141099595169058,1
"6911",1,1021200,823262,197938,47,0.0132566926266261,1
"6933",1,1371600,1048277,323323,44,0.00869907761723572,1
"6935",1,661200,491978,169222,39,0.0459972533932351,1
"6942",1,583200,501932,81268,49,0.0252198264557749,1
"6944",0,697200,553132,144068,43,0.0322066248490398,1
"6945",0,384000,279802,104198,26,0.184288964991439,1
"6967",0,1158000,900225,257775,35,0.0260772280681395,1
"6978",1,1203600,911658,291942,28,0.0407864783331072,1
"6981",1,710400,565275,145125,45,0.0269806118792307,1
"6984",0,435600,336491,99109,24,0.195126826277931,1
"6987",0,735600,499667,235933,20,0.157126297225775,1
"6992",0,1148400,933648,214752,28,0.0460849649054187,1
"6999",1,662400,509162,153238,36,0.0578971975018409,1
"7018",0,1152000,893831,258169,38,0.0208721581294058,1
"7026",0,471600,349022,122578,21,0.222493798674959,1
"7029",0,510000,384404,125596,23,0.185643382980541,1
"7042",0,574800,423496,151304,55,0.0156022306754663,1
"7053",1,610800,424173,186627,41,0.0427110630610361,1
"7059",1,489600,321178,168422,48,0.0308854640299662,1
"7065",0,914400,734255,180145,31,0.0549638406007731,1
"7067",0,505200,394334,110866,21,0.2132634048805,1
"7076",1,487200,384896,102304,41,0.0542042357082253,1
"7113",0,424800,322442,102358,25,0.185599804156495,1
"7116",0,572400,418366,154034,22,0.179481544196837,1
"7127",1,728400,533711,194689,42,0.0323464042430534,1
"7130",0,604800,509725,95075,21,0.186404992407297,1
"7132",0,385200,259937,125263,26,0.182708108989731,1
"7159",0,361200,267707,93493,24,0.216797699710439,1
"7164",0,492000,369576,122424,24,0.178696403713362,1
"7180",0,482400,339748,142652,20,0.23170252903943,1
"7183",1,922800,626534,296266,48,0.0139754089030813,1
"7198",0,597600,425952,171648,46,0.0299525565888461,1
"7203",1,494400,355730,138670,40,0.0569457529075537,1
"7219",0,543600,412129,131471,27,0.134986248552837,1
"7221",0,380400,295455,84945,24,0.211711735578986,1
"7244",0,404400,298128,106272,22,0.230346619812474,1
"7255",0,645600,485922,159678,20,0.183697600587678,1
"7259",1,882000,637745,244255,37,0.0359104751713122,1
"7270",1,524400,395601,128799,32,0.0979618227991772,1
"7277",0,643200,455040,188160,20,0.182617631953822,1
"7280",0,1131600,845995,285605,22,0.072264870537443,1
"7281",0,1069200,811850,257350,35,0.0303389932289754,1
"7288",0,537600,418243,119357,20,0.216514450789035,1
"7291",0,384000,318304,65696,20,0.269836828278625,1
"7299",1,812400,632878,179522,35,0.048183367251744,1
"7310",0,1431600,1117624,313976,21,0.0469773498574717,1
"7334",0,590400,448367,142033,22,0.175579551119019,1
"7338",0,440400,357435,82965,46,0.0404370538121932,1
"7345",1,694800,513274,181526,30,0.0846410440680023,1
"7362",0,961200,756931,204269,30,0.0543320173162109,1
"7365",0,841200,646299,194901,52,0.0122424234188082,1
"7371",0,360000,268832,91168,23,0.231128923340346,1
"7389",0,1327200,982246,344954,29,0.0300311653656082,1
"7394",0,393600,307160,86440,27,0.171263826896592,1
"7396",0,656400,464183,192217,51,0.0182311895466851,1
"7405",0,966000,704521,261479,52,0.00960428623424741,1
"7431",1,1092000,802287,289713,27,0.0530560417371968,1
"7433",0,511200,360642,150558,21,0.208862155836025,1
"7446",0,429600,325060,104540,52,0.0257527372751882,1
"7455",1,878400,635792,242608,42,0.0245927000149519,1
"7477",1,506400,371447,134953,38,0.0649081438459711,1
"7510",0,468000,342531,125469,22,0.209906672993507,1
"7518",0,409200,309040,100160,22,0.229291922400871,1
"7534",0,470400,336884,133516,22,0.208676676312332,1
"7538",1,362400,277259,85141,35,0.103673356738311,1
"7567",0,495600,366332,129268,23,0.189261886867667,1
"7569",0,526800,420411,106389,24,0.170831423099908,1
"7577",0,366000,288960,77040,28,0.167421592684748,1
"7584",0,396000,323216,72784,21,0.249971867267859,1
"7589",1,482400,327878,154522,38,0.0670151631176348,1
"7591",0,1034400,779140,255260,33,0.0375498079285274,1
"7598",1,778800,614331,164469,33,0.0595488263654736,1
"7632",0,1338000,902926,435074,32,0.0225673024492249,1
"7648",0,699600,543404,156196,41,0.0372182191546668,1
"7663",0,494400,354292,140108,24,0.177044316687259,1
"7666",1,438000,321343,116657,30,0.129550343777177,1
"7667",0,622800,483835,138965,22,0.167684698827507,1
"7675",1,848400,692804,155596,31,0.061857817596345,1
"7680",1,522000,353940,168060,45,0.0368132720158742,1
"7690",0,524400,360580,163820,38,0.0623398074592736,1
"7716",0,562800,424762,138038,56,0.0148073439833032,1
"7721",1,394800,340634,54166,26,0.184461028458609,1
"7748",0,444000,333698,110302,24,0.192127986656637,1
"7753",0,386400,301905,84495,27,0.173173423512648,1
"7763",1,996000,773218,222782,34,0.0375810154747977,1
"7769",0,579600,424602,154998,22,0.177574776169092,1
"7774",0,1006800,728268,278532,58,0.00553627058097005,1
"7777",0,500400,384552,115848,25,0.165656564293626,1
"7787",1,1362000,1031719,330281,43,0.00954328862754744,1
"7800",1,694800,529207,165593,26,0.113373937625175,1
"7801",0,1146000,874675,271325,44,0.0131295636538727,1
"7809",1,890400,616266,274134,46,0.0174322062704976,1
"7811",1,1246800,1012175,234625,46,0.00956104121444298,1
"7812",1,391200,315100,76100,25,0.196319709834997,1
"7838",1,1208400,954234,254166,44,0.011866234759211,1
"7845",0,405600,324103,81497,26,0.180007660738585,1
"7854",1,837600,607043,230557,31,0.0612143380604866,1
"7855",0,378000,280156,97844,22,0.239263910898899,1
"7859",0,817200,651699,165501,33,0.055868874126782,1
"7866",1,1320000,959554,360446,37,0.0162356608217229,1
"7876",0,495600,363579,132021,20,0.22836146740482,1
"7880",1,1261200,1043945,217255,50,0.0068509743038772,1
"7890",0,1154400,999362,155038,46,0.0115821901724923,1
"7894",0,1221600,966420,255180,35,0.0234155193324085,1
"7922",0,1377600,976316,401284,44,0.0083460787458425,1
"7928",0,553200,405965,147235,22,0.184899832378158,1
"7930",0,415200,307145,108055,20,0.255953939858233,1
"7932",0,494400,354360,140040,23,0.188921799887381,1
"7937",1,393600,300436,93164,34,0.105694044968786,1
"7953",0,601200,446178,155022,21,0.183730129574517,1
"7964",0,927600,694611,232989,28,0.0659557986940089,1
"7996",0,540000,403567,136433,22,0.18907426451086,1
"7997",1,1135200,798199,337001,46,0.0111403540800228,1
"8012",0,417600,303083,114517,43,0.0520988514912901,1
"8036",0,441600,354875,86725,20,0.248840516019424,1
"8043",0,484800,371119,113681,36,0.0785359589623601,1
"8045",1,1285200,942957,342243,36,0.0187716275786074,1
"8048",1,1255200,963753,291447,41,0.0136436844758999,1
"8052",0,438000,344759,93241,40,0.0635668724213249,1
"8053",0,361200,265081,96119,21,0.259773040915287,1
"8056",1,1266000,909002,356998,40,0.0141120855633703,1
"8069",1,1370400,1123184,247216,27,0.0338091230230828,1
"8080",0,379200,255638,123562,20,0.26693103866183,1
"8081",1,902400,745226,157174,43,0.0225848171243619,1
"8084",1,421200,307730,113470,47,0.0382441602935896,1
"8088",0,490800,383420,107380,23,0.191913483646136,1
"8096",0,372000,274950,97050,21,0.256079814161505,1
"8104",1,525600,391526,134074,27,0.138586647533907,1
"8110",0,541200,409971,131229,21,0.201554289426329,1
"8130",0,693600,511305,182295,48,0.0216875767932394,1
"8135",1,784800,593209,191591,47,0.0199736487855799,1
"8149",0,586800,402842,183958,20,0.198100506374297,1
"8153",1,781200,609654,171546,28,0.085536987654827,1
"8160",1,837600,655681,181919,35,0.0461560165706836,1
"8179",1,967200,698155,269045,42,0.0209059233501938,1
"8184",0,496800,378701,118099,23,0.189626910203603,1
"8188",0,1106400,861937,244463,35,0.0286224987143277,1
"8202",0,398400,266961,131439,27,0.167541131731184,1
"8208",0,1081200,861484,219716,43,0.016206665228795,1
"8222",1,886800,668649,218151,25,0.0882838903862339,1
"8241",1,876000,738100,137900,26,0.0860297429203608,1
"8245",0,495600,397146,98454,40,0.0577037600481976,1
"8247",0,513600,383239,130361,24,0.172754036557723,1
"8250",0,564000,429785,134215,20,0.207788118780576,1
"8266",1,1130400,909075,221325,28,0.0473723055157195,1
"8280",1,902400,604462,297938,36,0.0366859570479933,1
"8292",0,1186800,968626,218174,38,0.0199734079205637,1
"8302",0,481200,336134,145066,24,0.180145337652463,1
"8343",0,505200,395926,109274,23,0.187915145168316,1
"8346",0,391200,312718,78482,20,0.266355261050509,1
"8368",0,390000,297609,92391,22,0.23585192327992,1
"8375",0,554400,400663,153737,21,0.196429170272459,1
"8382",1,1112400,859976,252424,37,0.0241950398994861,1
"8383",1,627600,457841,169759,47,0.0263655082796317,1
"8405",0,624000,476393,147607,22,0.166908938563203,1
"8420",0,584400,438156,146244,21,0.188724244600326,1
"8432",0,638400,510154,128246,52,0.0178372085306921,1
"8437",0,846000,657242,188758,26,0.0885927242019623,1
"8449",0,586800,427326,159474,20,0.199665113123143,1
"8453",0,409200,286717,122483,21,0.241985752891754,1
"8456",0,564000,429569,134431,21,0.195000377524974,1
"8468",0,373200,277172,96028,27,0.175838667880131,1
"8481",0,601200,428879,172321,22,0.171127277864804,1
"8494",0,454800,345067,109733,22,0.214830722526252,1
"8498",0,776400,583000,193400,43,0.0276148379634435,1
"8506",0,1405200,1040309,364891,29,0.02609199490481,1
"8513",0,445200,344675,100525,26,0.168918649079637,1
"8532",0,649200,477175,172025,46,0.0274303988196782,1
"8548",0,864000,620183,243817,38,0.0342941212604846,1
"8553",0,967200,720224,246976,34,0.0390832357233781,1
"8566",0,547200,441975,105225,22,0.18905920905861,1
"8569",0,708000,542364,165636,59,0.00899974294038315,1
"8570",0,441600,301356,140244,44,0.0459606211940108,1
"8573",1,622800,475980,146820,28,0.110864728410914,1
"8596",0,1081200,738321,342879,29,0.0455128388087079,1
"8610",0,795600,664234,131366,31,0.0680628366631009,1
"8630",0,1311600,1026353,285247,34,0.0214370013422366,1
"8631",1,1317600,1084792,232808,28,0.0344301818098513,1
"8634",0,450000,327342,122658,52,0.024695376957591,1
"8637",0,1027200,673281,353919,45,0.0144274015351058,1
"8648",0,476400,353171,123229,20,0.234976711175045,1
"8653",0,1126800,846473,280327,45,0.0125044645108636,1
"8666",0,582000,451284,130716,21,0.190326805845196,1
"8704",0,940800,703697,237103,49,0.0128226777790279,1
"8712",0,780000,650016,129984,44,0.0260405408714506,1
"8721",0,680400,491957,188443,27,0.107157551307703,1
"8728",0,687600,531543,156057,42,0.0351824667789959,1
"8729",0,747600,593355,154245,40,0.0370796316675559,1
"8741",0,1039200,776505,262695,23,0.078654578555573,1
"8743",0,547200,384448,162752,21,0.197853555557736,1
"8746",1,1203600,904207,299393,49,0.00793056195721201,1
"8760",0,481200,340951,140249,23,0.192478157481399,1
"8765",0,550800,413332,137468,55,0.0163504150153627,1
"8775",0,1244400,915425,328975,37,0.0187231260773717,1
"8790",0,380400,292176,88224,52,0.0281849618294517,1
"8796",0,549600,406785,142815,20,0.211396348467419,1
"8808",0,1286400,971421,314979,31,0.0279115113354657,1
"8812",0,1156800,886427,270373,22,0.0697554615740947,1
"8814",0,630000,471875,158125,22,0.164870604978395,1
"8818",0,554400,445965,108435,23,0.175161229054827,1
"8826",0,664800,516238,148562,21,0.167964909875425,1
"8834",0,1342800,1049387,293413,21,0.0548812238656578,1
"8840",1,835200,592744,242456,45,0.020979949157888,1
"8845",0,897600,619898,277702,38,0.0319736714322881,1
"8857",0,361200,289066,72134,28,0.168873164164664,1
"8859",0,735600,516774,218826,34,0.0581337054445075,1
"8860",0,1312800,877143,435657,24,0.0435650010971676,1
"8875",0,1369200,1096512,272688,21,0.0529460625294881,1
"8887",0,517200,429528,87672,24,0.174304962821906,1
"8896",0,1440000,1095002,344998,29,0.0247786365178634,1
"8909",1,1116000,837852,278148,44,0.0137910840289413,1
"8910",0,458400,347778,110622,51,0.0264271612906532,1
"8912",0,598800,470460,128340,21,0.185976279833732,1
"8913",0,1264800,1011173,253627,21,0.063356914737748,1
"8914",0,384000,251637,132363,26,0.182596864859733,1
"8924",1,558000,406610,151390,43,0.0406252876565185,1
"8930",0,432000,342540,89460,40,0.064286687020043,1
"8931",0,908400,662898,245502,29,0.0628930894421109,1
"8942",1,516000,370314,145686,31,0.105959823029508,1
"8953",0,441600,340488,101112,26,0.169772799179575,1
"8954",0,706800,540981,165819,60,0.00833490474614621,1
"8955",1,366000,268539,97461,31,0.135810232756106,1
"8961",1,660000,544420,115580,45,0.0297383076463093,1
"8962",0,1191600,928093,263507,25,0.0527998491978039,1
"8975",1,1002000,748487,253513,48,0.0123948630090709,1
"8977",1,656400,509516,146884,29,0.0979441980603634,1
"9009",0,692400,546505,145895,20,0.172506823098275,1
"9016",1,1210800,938001,272799,39,0.0173513553904025,1
"9017",0,709200,540491,168709,20,0.167068210782241,1
"9025",0,396000,306273,89727,24,0.206871252077719,1
"9037",0,985200,700286,284914,36,0.0320514804638935,1
"9042",0,586800,439586,147214,44,0.035911682736318,1
"9051",0,1124400,822385,302015,40,0.0184085250180723,1
"9052",1,962400,712898,249502,28,0.0619116924503845,1
"9067",0,546000,425080,120920,20,0.21392279350973,1
"9073",1,706800,592539,114261,43,0.0320553259975088,1
"9075",0,574800,412767,162033,20,0.202880106835553,1
"9083",0,393600,278403,115197,29,0.148411083153276,1
"9095",0,436800,315584,121216,20,0.247828126461787,1
"9097",0,742800,495385,247415,38,0.0420082116088201,1
"9098",0,504000,411841,92159,33,0.0954284799649277,1
"9100",0,620400,437944,182456,37,0.056946019150538,1
"9103",1,784800,583265,201535,26,0.0971907024199991,1
"9109",0,409200,310573,98627,26,0.178070710218127,1
"9110",0,664800,471903,192897,51,0.0179648085895996,1
"9122",0,386400,294689,91711,20,0.266962289484119,1
"9124",1,964800,678275,286525,29,0.0564319517640069,1
"9125",1,686400,535497,150903,37,0.0516612902400169,1
"9131",0,1057200,747007,310193,51,0.00869925114949279,1
"9135",0,429600,309530,120070,20,0.250273409269792,1
"9136",1,1132800,848861,283939,35,0.0269458471918324,1
"9152",0,706800,552253,154547,28,0.096894726972686,1
"9167",0,417600,279798,137802,23,0.210556788689775,1
"9176",0,970800,717071,253729,54,0.00816188957758895,1
"9186",1,615600,476721,138879,36,0.0628738192554862,1
"9189",1,807600,669692,137908,40,0.0337162900409374,1
"9194",1,1299600,1097589,202011,39,0.0153106779721521,1
"9204",1,1440000,1100967,339033,25,0.0338128908140674,1
"9219",1,1300800,965208,335592,46,0.008362826592434,1
"9224",0,531600,417378,114222,24,0.16920135866056,1
"9242",1,1047600,829947,217653,34,0.0345128182556634,1
"9250",0,379200,278204,100996,21,0.253384476090345,1
"9266",1,645600,474632,170968,46,0.02761055392454,1
"9280",0,1381200,1013462,367738,37,0.0145669003365691,1
"9302",1,1012800,773124,239676,43,0.0180897350594974,1
"9307",0,394800,266222,128578,25,0.192039438672108,1
"9334",1,514800,351474,163326,36,0.0734487312414702,1
"9344",0,604800,484050,120750,21,0.184848297236215,1
"9345",0,624000,448316,175684,22,0.165348942261204,1
"9365",0,667200,541061,126139,20,0.1800679129697,1
"9375",0,806400,625527,180873,21,0.1345660374743,1
"9417",0,388800,296973,91827,24,0.208809554047261,1
"9427",0,469200,329135,140065,31,0.11421030488207,1
"9434",1,466800,349259,117541,36,0.0807338644490746,1
"9440",0,1238400,948735,289665,41,0.0140554354853004,1
"9445",0,380400,312949,67451,21,0.255538009255676,1
"9447",0,454800,347534,107266,32,0.110121907802082,1
"9449",1,1107600,820516,287084,25,0.0601272090001203,1
"9453",0,488400,369518,118882,21,0.217695755206468,1
"9456",0,484800,376137,108663,23,0.193468779153915,1
"9460",1,1372800,1044656,328144,39,0.0128355398364239,1
"9467",0,885600,706172,179428,39,0.0313907129039911,1
"9478",1,1216800,911400,305400,42,0.0134067397865469,1
"9485",0,894000,704885,189115,57,0.00755517467800909,1
"9488",0,799200,622775,176425,30,0.0716397228256735,1
"9495",0,470400,354736,115664,21,0.22333836913974,1
"9502",1,727200,483396,243804,37,0.0465859914086723,1
"9504",1,775200,581626,193574,33,0.059249031099254,1
"9526",0,790800,587170,203630,29,0.0773777767221016,1
"9551",1,877200,660908,216292,31,0.0576564686904678,1
"9558",0,499200,345606,153594,24,0.175039864939428,1
"9570",1,670800,490362,180438,48,0.0225679765129306,1
"9571",1,642000,504990,137010,25,0.133158823893622,1
"9587",0,1132800,827409,305391,30,0.0392412055542374,1
"9600",0,1256400,990512,265888,40,0.0148740922563326,1
"9601",1,1194000,951535,242465,32,0.0311024138871262,1
"9610",1,782400,619170,163230,39,0.0376141210337402,1
"9625",0,433200,319693,113507,25,0.182716779251123,1
"9649",0,702000,582168,119832,46,0.0255841031464962,1
"9654",0,810000,581515,228485,26,0.0924736978479045,1
"9660",0,399600,312502,87098,20,0.262819118943335,1
"9663",1,885600,659341,226259,41,0.0264158609876743,1
"9666",0,499200,362179,137021,38,0.0656271550432364,1
"9690",1,441600,328034,113566,47,0.0369495954090614,1
"9692",0,1342800,859801,482999,38,0.0137520293467081,1
"9700",1,1419600,1097607,321993,30,0.0239590910054247,1
"9701",0,576000,437584,138416,32,0.0899419041555756,1
"9749",1,1404000,1028697,375303,27,0.0303872273023416,1
"9768",0,422400,323271,99129,22,0.225302637265559,1
"9779",0,558000,409125,148875,20,0.208551759201276,1
"9786",1,1368000,1042573,325427,46,0.00747101863526896,1
"9799",0,656400,473874,182526,35,0.0623135938459215,1
"9800",1,966000,699875,266125,25,0.0763659764201767,1
"9803",0,416400,288675,127725,25,0.186287535417242,1
"9807",0,615600,466465,149135,21,0.180325155284233,1
"9810",1,790800,636595,154205,33,0.0586089260428111,1
"9818",1,894000,690388,203612,29,0.0654163073188969,1
"9829",0,484800,415043,69757,20,0.236188479324561,1
"9833",0,847200,589962,257238,41,0.0278638937091743,1
"9844",0,436800,334299,102501,24,0.194583530825286,1
"9845",0,1399200,1039681,359519,40,0.0111964182869935,1
"9847",0,619200,432439,186761,20,0.189064392164715,1
"9852",1,1413600,1074834,338766,26,0.0327486515629961,1
"9866",0,375600,273494,102106,27,0.174878068674106,1
"9880",1,880800,604702,276098,43,0.0223683403510983,1
"9902",0,434400,311684,122716,21,0.233962609382463,1
"9907",0,1288800,1031882,256918,26,0.0417220917381324,1
"9928",1,583200,415173,168027,32,0.0879572481174509,1
"9941",1,1368000,961610,406390,29,0.0273540737368711,1
"9957",0,433200,351768,81432,21,0.237323648133356,1
"9958",1,1291200,897515,393685,39,0.0144012441134442,1
"9964",0,462000,345147,116853,20,0.240008600405143,1
"9975",0,822000,644069,177931,45,0.0220105384935043,1
"9985",0,511200,369035,142165,20,0.222875411640701,1
"9999",1,631200,437518,193682,49,0.0222313569465968,1
"10010",0,376800,305938,70862,25,0.20066777856146,1
"10013",0,628800,457620,171180,43,0.0357818433686419,1
"10019",0,1213200,862971,350229,27,0.0423498637614787,1
"10021",0,567600,390873,176727,22,0.179379710099642,1
"10023",0,975600,689834,285766,31,0.047691374759941,1
"10024",0,459600,354909,104691,20,0.241669286078372,1
"10036",0,1038000,814751,223249,23,0.0799633102707523,1
"10075",0,730800,549097,181703,52,0.0148937931987921,1
"10078",0,1438800,1085838,352962,45,0.00706948189745167,1
"10104",0,392400,283120,109280,22,0.233878986924258,1
"10106",1,396000,305935,90065,33,0.113144350603489,1
"10108",0,428400,339964,88436,26,0.173786377336263,1
"10119",1,1366800,954249,412551,46,0.00723139201763556,1
"10124",0,589200,461567,127633,37,0.0612051390451838,1
"10126",1,1358400,975767,382633,25,0.0381610653705009,1
"10142",0,524400,397099,127301,22,0.193872498518535,1
"10145",0,470400,343221,127179,23,0.196262032358257,1
"10164",0,970800,738782,232018,43,0.0195029165004183,1
"10193",0,980400,699804,280596,39,0.0256800657312327,1
"10199",1,1320000,1045304,274696,27,0.0364266962929761,1
"10201",1,1204800,857044,347756,25,0.0500246379129424,1
"10205",0,825600,581218,244382,22,0.119231040935497,1
"10211",0,590400,369420,220980,22,0.171043110430945,1
"10215",0,536400,387798,148602,22,0.189293127305269,1
"10231",1,530400,410936,119464,33,0.0906032642266383,1
"10236",1,447600,327734,119866,30,0.127522107057547,1
"10238",0,528000,398452,129548,20,0.218682176011644,1
"10242",0,794400,639672,154728,22,0.129081065654237,1
"10260",0,482400,393796,88604,44,0.0437849025339606,1
"10261",0,1005600,772876,232724,41,0.0214601359707802,1
"10273",0,434400,325738,108662,20,0.24955459654692,1
"10280",1,1257600,853308,404292,32,0.0262059695214284,1
"10285",0,368400,279709,88691,24,0.214988219376627,1
"10299",0,496800,363380,133420,55,0.0179724463799952,1
"10303",1,735600,534715,200885,44,0.0273220517685835,1
"10305",1,796800,618762,178038,36,0.0458750047346428,1
"10312",1,816000,618769,197231,25,0.0995412861141845,1
"10328",0,940800,704466,236334,49,0.0128265825615442,1
"10329",0,400800,330398,70402,20,0.263710138033907,1
"10340",0,468000,386328,81672,22,0.212834786255288,1
"10351",0,412800,311118,101682,22,0.228071683411578,1
"10404",0,387600,263532,124068,24,0.207026203542302,1
"10434",0,591600,437033,154567,22,0.174549909102946,1
"10435",0,882000,724375,157625,40,0.0294908545693944,1
"10437",1,1149600,858659,290941,28,0.0446702739055101,1
"10463",0,615600,438608,176992,44,0.0338126080457909,1
"10467",0,1437600,1027324,410276,28,0.0262058920753627,1
"10476",1,754800,576348,178452,28,0.0890003192528471,1
"10481",0,542400,403768,138632,21,0.200739332655825,1
"10492",0,913200,693231,219969,43,0.0216313656417294,1
"10499",0,679200,502569,176631,20,0.174053975026491,1
"10501",0,373200,250371,122829,27,0.174286301873918,1
"10504",0,657600,475751,181849,21,0.167862125907996,1
"10518",0,436800,329242,107558,30,0.130200357287888,1
"10541",0,574800,421905,152895,52,0.0197061195574732,1
"10563",1,1376400,993236,383164,45,0.00778565697401822,1
"10566",1,387600,304321,83279,34,0.107070309703564,1
"10586",0,1070400,807970,262430,46,0.0128366212884172,1
"10601",0,988800,743537,245263,29,0.0550893500596984,1
"10609",1,439200,343907,95293,36,0.0850884264217446,1
"10615",0,499200,371449,127751,41,0.0526252312402036,1
"10621",0,682800,501485,181315,20,0.172880269637688,1
"10625",0,550800,431145,119655,20,0.212596880115946,1
"10645",0,614400,439748,174652,26,0.127917731239268,1
"10649",0,504000,376189,127811,23,0.187102772642087,1
"10652",0,878400,598457,279943,25,0.0874770362135212,1
"10653",1,1436400,1143460,292940,40,0.0107783777959653,1
"10656",0,470400,357597,112803,20,0.237628468664439,1
"10665",0,495600,367506,128094,20,0.228639128316117,1
"10670",0,633600,483417,150183,42,0.0386265948288467,1
"10673",1,582000,455209,126791,38,0.0574942698558297,1
"10686",0,502800,380842,121958,23,0.187780545773359,1
"10687",1,376800,281784,95016,35,0.100991999116399,1
"10699",1,1329600,1004473,325127,41,0.011837140269445,1
"10704",1,778800,590339,188461,29,0.0793354215856964,1
"10707",1,1248000,938000,310000,48,0.0079101028012693,1
"10732",1,1288800,839499,449301,36,0.0178857193958625,1
"10742",0,820800,638158,182642,37,0.0407688051189723,1
"10758",0,596400,428247,168153,20,0.196440784690816,1
"10760",0,561600,386666,174934,23,0.169557353385702,1
"10769",1,957600,703362,254238,31,0.0497386113541811,1
"10778",0,402000,298009,103991,25,0.191612528520305,1
"10779",1,424800,342699,82101,28,0.153284959774071,1
"10791",1,1405200,1082251,322949,42,0.00960676760783766,1
"10803",0,510000,358172,151828,20,0.222568454566872,1
"10819",0,632400,485408,146992,21,0.176139948493646,1
"10823",0,585600,418759,166841,22,0.175356755941339,1
"10842",0,951600,749403,202197,44,0.0188661711314139,1
"10851",1,1251600,932449,319151,47,0.00847429767979137,1
"10881",0,652800,434674,218126,21,0.167006223209239,1
"10883",1,1426800,1090606,336194,46,0.00671571443859743,1
"10887",0,650400,463655,186745,40,0.0431223534639427,1
"10888",1,1140000,821056,318944,50,0.00812282770593936,1
"10893",0,450000,359621,90379,21,0.231398255322802,1
"10899",0,732000,528910,203090,48,0.0201398281249999,1
"10901",1,1261200,1024097,237103,47,0.00861054871066919,1
"10917",0,1105200,844292,260908,26,0.0565711372245962,1
"10918",0,406800,306367,100433,26,0.17858071969361,1
"10921",0,1405200,1063769,341431,33,0.0193020398655459,1
"10926",1,1196400,899366,297034,39,0.0176177951993284,1
"10935",0,649200,487559,161641,20,0.182636090744098,1
"10950",0,361200,270429,90771,25,0.203789122417751,1
"10953",1,642000,511987,130013,50,0.0207021293372147,1
"10965",1,638400,476762,161638,36,0.0600435097164808,1
"10968",0,447600,367008,80592,23,0.205675945001845,1
"10977",0,385200,280360,104840,24,0.208989406544531,1
"10978",1,1122000,864863,257137,35,0.0277348685256464,1
"10989",0,486000,331781,154219,22,0.202853102313608,1
"10994",0,692400,528174,164226,20,0.171459834815901,1
"10997",1,778800,595766,183034,43,0.0276135641675402,1
"11004",0,986400,745131,241269,31,0.0476425392518754,1
"11042",0,429600,284548,145052,49,0.0319521612907946,1
"11049",1,776400,560528,215872,26,0.0979803858926206,1
"11055",0,1269600,936088,333512,24,0.048693084775274,1
"11060",0,9e+05,665944,234056,27,0.0742500791017118,1
"11062",0,583200,434374,148826,22,0.177015821841463,1
"11079",1,931200,674368,256832,28,0.0649847948449983,1
"11092",1,1118400,902650,215750,47,0.0111251943581484,1
"11093",1,498000,372640,125360,27,0.144893653772957,1
"11104",1,1414800,1124373,290427,32,0.0209391437586942,1
"11106",1,1438800,1081544,357256,33,0.0181054423591736,1
"11121",0,561600,403264,158336,23,0.170496791533439,1
"11123",0,1435200,1133016,302184,39,0.0116407118022324,1
"11132",0,411600,292958,118642,22,0.227245317123671,1
"11151",0,525600,361017,164583,23,0.179234785700107,1
"11153",0,530400,401451,128949,22,0.192132196966552,1
"11166",0,1323600,1024501,299099,20,0.0609201871014533,1
"11168",1,1357200,1236733,120467,48,0.00705468142018158,1
"11175",0,369600,269900,99700,24,0.21389022936097,1
"11178",0,397200,284402,112798,60,0.0145541511364288,1
"11185",1,382800,296396,86404,42,0.0601196964344764,1
"11193",1,1299600,933489,366111,28,0.0337086051975189,1
"11211",0,498000,373539,124461,51,0.0245661232378525,1
"11219",1,566400,422407,143993,42,0.0433472110176496,1
"11228",0,508800,371535,137265,48,0.0302588350238698,1
"11229",0,384000,275421,108579,21,0.251224203278235,1
"11244",0,384000,288661,95339,23,0.22345042370075,1
"11252",0,511200,377904,133296,20,0.223492129732113,1
"11262",1,994800,765893,228907,29,0.0548839648685447,1
"11271",0,596400,419602,176798,46,0.0299536303434735,1
"11279",1,361200,278079,83121,40,0.0723348007409074,1
"11280",1,546000,381061,164939,40,0.0517610315685733,1
"11292",1,590400,453306,137094,33,0.08177370153229,1
"11294",1,715200,580048,135152,32,0.0719624661726249,1
"11316",1,520800,359366,161434,28,0.12908358003442,1
"11330",0,1374000,1039191,334809,41,0.0109188913948797,1
"11331",0,366000,283115,82885,26,0.190391367345413,1
"11336",1,1111200,781479,329721,50,0.00850311745157454,1
"11347",0,1407600,1032169,375431,46,0.00683619997178067,1
"11349",0,746400,518395,228005,31,0.0711345467992944,1
"11352",0,462000,342762,119238,54,0.0207411840437341,1
"11393",1,1279200,972866,306334,40,0.0140730800484704,1
"11398",0,370800,258671,112129,54,0.024315340220555,1
"11399",0,420000,302100,117900,26,0.174203195433739,1
"11402",1,1167600,863577,304023,32,0.0317589106297529,1
"11413",0,446400,322182,124218,22,0.216337123899104,1
"11418",0,872400,632306,240094,51,0.0123231269719186,1
"11428",0,1309200,1016719,292481,28,0.0341251081593717,1
"11450",1,744000,618892,125108,45,0.0256774916389666,1
"11455",0,630000,469758,160242,21,0.175979033900961,1
"11461",1,360000,248985,111015,37,0.0893075136653968,1
"11463",0,492000,393659,98341,21,0.218024798164544,1
"11471",1,556800,424027,132773,27,0.132248528895951,1
"11482",0,411600,322421,89179,21,0.243668553483274,1
"11486",1,571200,415517,155683,31,0.0967895832728672,1
"11493",0,465600,347855,117745,24,0.185870012370466,1
"11498",1,610800,445383,165417,29,0.10453548654152,1
"11507",0,1270800,897411,373389,49,0.00685098298872584,1
"11513",1,800400,625625,174775,46,0.021158871200905,1
"11519",0,495600,372155,123445,25,0.166399147424773,1
"11529",0,387600,288948,98652,26,0.183675948182624,1
"11536",0,1404000,1001759,402241,27,0.0300705011452015,1
"11571",1,1352400,966433,385967,38,0.0140549782919542,1
"11572",0,495600,383383,112217,22,0.202857311197973,1
"11593",0,411600,326980,84620,25,0.190214493736574,1
"11595",1,864000,686099,177901,40,0.0301681740034015,1
"11597",1,842400,636207,206193,40,0.030953180065891,1
"11604",0,1002000,733752,268248,54,0.00768650447849939,1
"11611",0,535200,406494,128706,21,0.203415312176333,1
"11612",1,555600,404752,150848,42,0.0440228628412321,1
"11613",0,1196400,877339,319061,46,0.0100905768226541,1
"11630",1,525600,348304,177296,30,0.110785231158632,1
"11641",1,806400,606511,199889,31,0.0651776473097904,1
"11661",0,373200,278945,94255,22,0.241061294975146,1
"11663",0,517200,390890,126310,56,0.0160935164608752,1
"11666",0,1183200,856204,326996,22,0.0654109307807046,1
"11670",0,1328400,994104,334296,28,0.0325019802564785,1
"11673",1,487200,355629,131571,40,0.0577818391647145,1
"11674",0,500400,381581,118819,24,0.176756889944923,1
"11681",0,897600,702332,195268,36,0.0384792712113957,1
"11690",1,542400,347251,195149,44,0.0379954471669743,1
"11697",0,940800,719182,221618,32,0.0480220874442654,1
"11700",0,585600,435306,150294,22,0.176318532857565,1
"11707",0,523200,399991,123209,20,0.220559291875222,1
"11710",0,571200,453688,117512,23,0.170433661238627,1
"11716",0,1411200,1038533,372667,21,0.04752671457645,1
"11721",0,501600,422047,79553,25,0.167385158651009,1
"11734",1,489600,338109,151491,32,0.102642036836469,1
"11752",0,367200,287946,79254,26,0.190291781042358,1
"11767",0,396000,317558,78442,43,0.0547437413669038,1
"11775",0,1387200,1117346,269854,27,0.0325733340079238,1
"11784",1,450000,342804,107196,34,0.096220261809633,1
"11786",0,529200,390398,138802,22,0.191845312788208,1
"11792",0,1113600,857436,256164,46,0.0119416327614717,1
"11799",1,1224000,921097,302903,34,0.0247332065373256,1
"11826",0,1329600,1019922,309678,28,0.0327472425502307,1
"11829",0,415200,281352,133848,25,0.186233987102804,1
"11841",0,762000,610440,151560,27,0.0954972278718958,1
"11854",1,920400,763679,156721,49,0.0137123396536085,1
"11858",0,507600,395380,112220,45,0.0385397770457977,1
"11877",0,717600,550739,166861,20,0.165132339915036,1
"11884",0,909600,751476,158124,27,0.0751927439349467,1
"11893",0,1023600,764978,258622,21,0.0933910717343222,1
"11900",0,1405200,1129740,275460,38,0.0134026102252967,1
"11938",0,568800,385256,183544,41,0.0458772659956146,1
"11950",0,420000,313364,106636,21,0.239688131698809,1
"11964",0,1054800,774257,280543,40,0.0209221394157419,1
"11966",0,769200,533958,235242,57,0.00921397336554472,1
"11999",0,390000,297733,92267,23,0.221844206779083,1
"12017",0,902400,651975,250425,57,0.00726607395552778,1
"12019",0,493200,385114,108086,23,0.191218403838141,1
"12031",1,1022400,739808,282592,36,0.030117098075363,1
"12032",0,384000,306905,77095,22,0.238865417159931,1
"12038",0,369600,273702,95898,40,0.0710145842527178,1
"12044",0,584400,430743,153657,32,0.0882513801883568,1
"12092",0,903600,670664,232936,51,0.0117083868398197,1
"12097",0,835200,574702,260498,33,0.0523071760692071,1
"12128",1,678000,501984,176016,40,0.0413406801132709,1
"12135",0,613200,480953,132247,21,0.18195356118488,1
"12144",1,1242000,903974,338026,50,0.00675101553429009,1
"12148",1,1406400,948458,457942,36,0.0145541554426024,1
"12156",0,536400,377595,158805,20,0.214196217213851,1
"12163",0,402000,290398,111602,27,0.167771200303554,1
"12177",0,458400,339840,118560,25,0.175921496973944,1
"12199",1,758400,600531,157869,38,0.0423549583779446,1
"12222",0,676800,456565,220235,43,0.0323689039417443,1
"12231",0,718800,501257,217543,42,0.0325868302635453,1
"12235",0,412800,304098,108702,20,0.256706057325884,1
"12240",1,414000,288987,125013,30,0.133977220607154,1
"12259",0,580800,455126,125674,37,0.0621020302469909,1
"12299",1,1387200,1173403,213797,46,0.00755402114751719,1
"12313",0,376800,271506,105294,20,0.269193658083162,1
"12316",0,370800,280805,89995,28,0.165533593364692,1
"12318",0,402000,303118,98882,21,0.246059083328899,1
"12326",0,373200,279705,93495,27,0.175985945301943,1
"12336",1,705600,562152,143448,38,0.0465261755290453,1
"12344",0,382800,292786,90014,26,0.185463107747994,1
"12345",0,778800,628512,150288,56,0.0101399501236562,1
"12351",1,843600,593439,250161,49,0.0150892614095069,1
"12352",1,1246800,920896,325904,34,0.0235743941982936,1
"12368",0,970800,743505,227295,29,0.0571412844468856,1
"12390",1,1360800,976462,384338,26,0.0351833942086693,1
"12398",0,465600,331514,134086,23,0.1971531988348,1
"12402",0,598800,453276,145524,22,0.173258663429178,1
"12430",1,813600,595646,217954,33,0.0550969504564621,1
"12439",0,778800,582797,196003,53,0.0126036536505346,1
"12441",1,550800,417082,133718,32,0.0937819686427117,1
"12447",1,1226400,866941,359459,27,0.0412750121870722,1
"12459",0,824400,624206,200194,41,0.0296171520552742,1
"12461",0,1183200,906181,277019,24,0.0574182660948327,1
"12463",0,668400,417938,250462,53,0.0149277143063152,1
"12466",1,571200,418076,153124,31,0.096879346596342,1
"12469",0,554400,402728,151672,23,0.172669828639148,1
"12490",1,501600,356209,145391,34,0.0874102984898246,1
"12504",0,504000,386379,117621,24,0.175910568102819,1
"12525",0,488400,355415,132985,45,0.0394887279686148,1
"12535",0,963600,739764,223836,49,0.0123916776556649,1
"12536",0,538800,401823,136977,24,0.166167022573722,1
"12569",1,823200,643926,179274,26,0.0921895823318564,1
"12570",0,417600,334926,82674,23,0.21425561772979,1
"12589",1,1396800,1099952,296848,41,0.0106551002278359,1
"12592",0,1285200,1008273,276927,30,0.0306616952038566,1
"12600",0,722400,560489,161911,46,0.0243045506535941,1
"12614",0,369600,279072,90528,26,0.188950778952814,1
"12619",0,878400,648868,229532,33,0.0492581535244711,1
"12630",0,896400,617425,278975,49,0.0136182152831313,1
"12642",1,1320000,994721,325279,42,0.0111259146473841,1
"12646",1,1143600,862640,280960,44,0.0131339779632752,1
"12651",0,739200,536355,202845,36,0.0500254656010646,1
"12653",0,700800,474734,226066,20,0.165918182294264,1
"12657",1,804000,606941,197059,27,0.0878538934752525,1
"12678",1,681600,473983,207617,37,0.0509633940485039,1
"12689",1,1010400,758191,252209,28,0.0571449521926439,1
"12692",0,796800,570676,226124,26,0.0945140175853926,1
"12693",1,1220400,916055,304345,47,0.00899898990118189,1
"12695",1,862800,624977,237823,43,0.0234170051323079,1
"12700",1,1035600,779893,255707,32,0.0404401278943482,1
"12701",0,361200,256249,104951,23,0.229775683484222,1
"12709",0,1341600,1027400,314200,44,0.00919753995826065,1
"12714",1,576000,453402,122598,29,0.112079964593948,1
"12733",0,367200,301107,66093,28,0.167740778456556,1
"12765",1,1346400,988549,357851,49,0.0060434692299064,1
"12774",1,1363200,1025902,337298,42,0.0102741066584922,1
"12788",0,548400,405704,142696,23,0.174695218951622,1
"12796",1,9e+05,698080,201920,39,0.0303658399214146,1
"12807",0,1374000,979936,394064,33,0.0199475781703801,1
"12816",1,1306800,991404,315396,49,0.00658532636308904,1
"12835",0,1053600,773935,279665,21,0.0883525463829293,1
"12836",1,951600,746164,205436,45,0.0174282444943314,1
"12838",0,378000,281911,96089,23,0.225227378276,1
"12843",1,1322400,912514,409886,32,0.0234079746889316,1
"12853",0,531600,404939,126661,46,0.0340905990176882,1
"12871",0,595200,443227,151973,22,0.173792306349349,1
"12873",0,676800,525114,151686,51,0.0178856568634859,1
"12874",1,700800,454755,246045,43,0.030767220372562,1
"12884",1,1405200,1115413,289787,43,0.00899743726067619,1
"12888",0,482400,361192,121208,31,0.112645128595585,1
"12890",1,997200,764108,233092,36,0.032044023090909,1
"12894",1,637200,521446,115754,48,0.0245165972248753,1
"12899",1,1392000,1078706,313294,40,0.0115466427855268,1
"12903",1,675600,535329,140271,26,0.117851471174159,1
"12904",0,1213200,834676,378524,36,0.0209414877101762,1
"12925",0,561600,397991,163609,22,0.181713433353844,1
"12933",0,744000,544378,199622,22,0.137192257865855,1
"12950",1,752400,590393,162007,37,0.0460846473387994,1
"12956",0,634800,453577,181223,33,0.0748838789247781,1
"12961",0,410400,294783,115617,59,0.0153672127018819,1
"12965",1,1356000,1051373,304627,48,0.00656938107500263,1
"12968",1,1381200,1024955,356245,41,0.0106921623454763,1
"12979",0,1269600,885480,384120,22,0.0555294921466497,1
"12980",0,519600,353919,165681,26,0.14807250330143,1
"12995",0,535200,384044,151156,22,0.189458638394949,1
"12999",0,430800,296407,134393,57,0.0172182251324499,1
"13006",0,658800,536531,122269,21,0.170928461556434,1
"13010",0,585600,458590,127010,23,0.166367061115641,1
"13011",0,674400,491272,183128,45,0.0282651829866225,1
"13014",0,376800,272055,104745,23,0.224988537036206,1
"13016",1,1156800,895294,261506,34,0.0281892665814749,1
"13023",1,918000,688451,229549,30,0.0578001250600135,1
"13041",0,621600,484227,137373,22,0.168067604605129,1
"13059",0,872400,668587,203813,36,0.0400147116582855,1
"13068",0,414000,329354,84646,23,0.215185806285461,1
"13081",0,428400,329456,98944,26,0.173182063999359,1
"13088",1,920400,736721,183679,33,0.0467365376243659,1
"13095",1,1164000,882014,281986,36,0.0236620471431091,1
"13096",0,442800,328392,114408,21,0.231928245588457,1
"13106",0,430800,355171,75629,20,0.253234978747547,1
"13111",0,601200,447937,153263,22,0.172214220847961,1
"13115",1,588000,469978,118022,49,0.0246568907007904,1
"13121",0,446400,313202,133198,26,0.166794545348454,1
"13132",0,477600,376485,101115,24,0.183707535569308,1
"13141",0,360000,260179,99821,25,0.203541422914212,1
"13148",0,446400,331870,114530,26,0.167837693287772,1
"13169",0,422400,312924,109476,26,0.17408435364309,1
"13181",0,603600,396840,206760,60,0.00980958395844454,1
"13188",0,655200,486470,168730,60,0.00910583235154058,1
"13211",1,800400,507930,292470,26,0.0917342443982032,1
"13217",0,440400,317062,123338,23,0.204936936968693,1
"13219",1,592800,478944,113856,47,0.0285929698414627,1
"13220",0,367200,239305,127895,27,0.175510140413821,1
"13227",0,370800,295271,75529,20,0.273633176632282,1
"13231",0,832800,666807,165993,27,0.0848560153880998,1
"13239",1,379200,268195,111005,36,0.093103863735332,1
"13247",1,1395600,1101761,293839,49,0.00569053313034368,1
"13253",0,369600,262910,106690,56,0.0209051003828228,1
"13254",1,1208400,911535,296865,31,0.032093599383114,1
"13255",1,1147200,877555,269645,44,0.0131110645591324,1
"13264",0,1158000,910001,247999,47,0.0102550909107247,1
"13270",0,405600,294463,111137,39,0.0716941776010842,1
"13285",0,758400,561183,197217,20,0.153919231819934,1
"13295",0,549600,415110,134490,25,0.153110732409878,1
"13316",0,525600,418193,107407,20,0.220926172116673,1
"13320",0,837600,625425,212175,54,0.0104563114488869,1
"13347",0,451200,357764,93436,21,0.230806779125541,1
"13354",0,1083600,781427,302173,50,0.00901887339339851,1
"13364",1,634800,452924,181876,27,0.115313346049215,1
"13373",0,844800,589984,254816,38,0.0352754095431103,1
"13375",0,874800,681614,193186,45,0.0199845899030813,1
"13382",1,1269600,905441,364159,26,0.0413489932284378,1
"13385",0,582000,430313,151687,21,0.18903401599827,1
"13391",0,799200,628169,171031,53,0.0122874679735483,1
"13398",0,502800,323805,178995,20,0.222866031304696,1
"13405",1,1082400,829795,252605,28,0.0507080637751084,1
"13415",1,1044000,773415,270585,43,0.0169362489006513,1
"13416",0,460800,339627,121173,23,0.199313008391184,1
"13418",1,1256400,865525,390875,44,0.0103429519200011,1
"13420",0,586800,422899,163901,20,0.199381528183458,1
"13428",1,978000,704197,273803,43,0.018949062870346,1
"13437",0,1341600,1068826,272774,20,0.0597309800542753,1
"13449",0,436800,353345,83455,26,0.171967573584345,1
"13462",0,362400,270974,91426,26,0.190835991375323,1
"13463",0,1063200,851451,211749,35,0.0311978724459189,1
"13471",1,1365600,979400,386200,43,0.00927546689171388,1
"13473",0,1315200,963303,351897,22,0.052119865570136,1
"13475",0,361200,252554,108646,22,0.243862897190754,1
"13481",0,471600,345026,126574,24,0.183752750784432,1
"13505",1,716400,569114,147286,37,0.0492137968129767,1
"13531",0,1245600,1005430,240170,27,0.0418407679340452,1
"13532",0,1113600,809364,304236,25,0.0591518443258499,1
"13538",0,574800,439822,134978,33,0.0839148478607365,1
"13542",0,476400,386249,90151,24,0.184684268645149,1
"13556",0,645600,492635,152965,58,0.0109039964056964,1
"13565",0,800400,593702,206698,22,0.125596778747161,1
"13566",0,1074000,828618,245382,46,0.0128433398854344,1
"13573",0,555600,429804,125796,34,0.0807331308498212,1
"13582",1,650400,495071,155329,37,0.0547484205966598,1
"13588",0,714000,549699,164301,49,0.0195112692359629,1
"13615",0,1365600,958980,406620,27,0.032041587194762,1
"13617",0,583200,455331,127869,45,0.0337156025826448,1
"13618",0,1239600,934269,305331,50,0.00686814031567336,1
"13647",1,990000,783008,206992,43,0.0190566514450291,1
"13654",1,926400,663924,262476,41,0.0242916469645674,1
"13675",1,1010400,782003,228397,38,0.0269039950347996,1
"13684",1,784800,638578,146222,42,0.0299519693109626,1
"13698",1,730800,567958,162842,38,0.0442759177563813,1
"13704",0,973200,696648,276552,40,0.0240980474357767,1
"13708",0,441600,314798,126802,23,0.204368567094494,1
"13715",1,1234800,1021383,213417,38,0.0184264336424498,1
"13725",0,1294800,949274,345526,27,0.0369833718249605,1
"13727",1,596400,473643,122757,45,0.0330356334973617,1
"13746",0,590400,411051,179349,21,0.185108709797931,1
"13760",0,1186800,942251,244549,55,0.00519784744424066,1
"13762",1,444000,330892,113108,38,0.0724547662354762,1
"13764",0,456000,356370,99630,20,0.243200535036847,1
"13769",0,1101600,860030,241570,22,0.0771166515905995,1
"13789",0,1359600,1097540,262060,33,0.0215346124065894,1
"13791",0,590400,450727,139673,53,0.0178385031254654,1
"13818",0,583200,470956,112244,21,0.191145854275429,1
"13826",0,1137600,837964,299636,44,0.0131732054402182,1
"13827",1,957600,778373,179227,34,0.0407693402590226,1
"13832",0,552000,398362,153638,23,0.17315844040858,1
"13836",0,1260000,952308,307692,25,0.0463282604018045,1
"13837",1,957600,745411,212189,26,0.0733813656378386,1
"13848",1,542400,387148,155252,25,0.153667560039347,1
"13852",0,1230000,1009845,220155,32,0.0295120327564665,1
"13854",0,751200,537393,213807,39,0.0388786315482708,1
"13860",1,501600,367710,133890,27,0.143692423572582,1
"13869",0,1206000,926908,279092,41,0.0149264379288449,1
"13873",1,583200,424446,158754,44,0.0359698615132439,1
"13878",0,1119600,819497,300103,53,0.00669316687359688,1
"13881",1,1117200,855308,261892,39,0.0204680448163722,1
"13887",1,866400,653527,212873,49,0.0147223017647517,1
"13904",0,405600,284984,120616,24,0.202119770599434,1
"13911",0,402000,311094,90906,21,0.246653027725574,1
"13921",0,799200,612673,186527,41,0.0310774388419678,1
"13933",0,446400,338456,107944,25,0.179616942639872,1
"13940",0,418800,290774,128026,23,0.210859214120215,1
"13968",0,363600,266811,96789,28,0.166904267573014,1
"13980",1,813600,609959,203641,35,0.0476461560374383,1
"13984",0,391200,293962,97238,49,0.0347373810480809,1
"13986",0,963600,738279,225321,34,0.0396502144736447,1
"14013",1,428400,345263,83137,44,0.0480217669981978,1
"14021",1,1038000,727238,310762,31,0.0425540201073256,1
"14044",0,361200,254780,106420,26,0.190232751084101,1
"14047",0,450000,361046,88954,20,0.245933861843855,1
"14049",0,1202400,829001,373399,25,0.049736498652255,1
"14050",1,576000,400848,175152,25,0.145173036090584,1
"14056",0,397200,269234,127966,20,0.260464912446354,1
"14061",1,692400,500726,191674,44,0.0295128072863792,1
"14070",0,775200,532822,242378,34,0.0539648378206758,1
"14076",0,592800,468138,124662,54,0.0165281398377203,1
"14079",0,709200,540483,168717,49,0.0196386812646263,1
"14091",0,420000,303425,116575,30,0.133152301563683,1
"14095",1,957600,723824,233776,35,0.036986179005853,1
"14100",1,547200,450609,96591,39,0.0571507039228019,1
"14129",1,476400,346783,129617,42,0.0506545669321705,1
"14141",1,1203600,842550,361050,35,0.0231670004126338,1
"14145",0,829200,663303,165897,30,0.0684905493191053,1
"14147",0,1038000,806668,231332,35,0.0323138475930929,1
"14149",0,759600,597045,162555,47,0.0210956524132527,1
"14153",0,823200,601208,221992,23,0.112446556208927,1
"14163",0,490800,383266,107534,25,0.168461042775921,1
"14164",0,589200,466963,122237,20,0.201385281375757,1
"14168",1,548400,386151,162249,36,0.0695695534310845,1
"14172",0,494400,382647,111753,21,0.216395183123852,1
"14181",0,1116000,868514,247486,31,0.0382437860839627,1
"14194",0,586800,425562,161238,20,0.199552078476963,1
"14206",1,1378800,1131474,247326,44,0.00885450163751604,1
"14232",0,529200,357140,172060,21,0.202303439228997,1
"14247",1,1158000,944881,213119,49,0.00888407901418178,1
"14249",1,1095600,914735,180865,27,0.0549641384186644,1
"14258",0,602400,458883,143517,22,0.172471888856121,1
"14264",0,370800,287732,83068,21,0.257551432945386,1
"14281",0,1102800,835141,267659,46,0.0121116883740465,1
"14307",0,1082400,759243,323157,22,0.0771819647645528,1
"14312",0,402000,300217,101783,20,0.260867968207007,1
"14324",1,1005600,658246,347354,37,0.0279751298232142,1
"14348",0,1395600,1070744,324856,43,0.00902203240635159,1
"14354",0,1009200,740516,268684,34,0.0361071591664245,1
"14356",0,452400,347122,105278,22,0.215843145531152,1
"14362",1,588000,426033,161967,32,0.0874787462243876,1
"14365",1,1172400,847340,325060,26,0.0493835550139706,1
"14367",0,1410000,1067645,342355,44,0.00807627794820363,1
"14368",0,812400,560275,252125,59,0.00725252301665109,1
"14370",0,673200,517205,155995,21,0.165505961111575,1
"14388",1,980400,709164,271236,50,0.0109203023216308,1
"14391",0,804000,618100,185900,45,0.0226289574984043,1
"14397",1,748800,572052,176748,26,0.103788695297968,1
"14417",0,1302000,1016751,285249,24,0.0469891137632728,1
"14420",0,506400,363547,142853,22,0.197857209876667,1
"14426",1,1434000,1093104,340896,33,0.0183735338502721,1
"14429",0,625200,461088,164112,24,0.144883925158258,1
"14437",0,396000,295376,100624,47,0.0400995460203489,1
"14439",1,480000,358392,121608,46,0.037268954157688,1
"14440",1,1432800,1060669,372131,44,0.0076710168077861,1
"14446",0,1365600,1041288,324312,26,0.0357190460769675,1
"14449",0,415200,328066,87134,20,0.257555204577653,1
"14463",0,439200,314022,125178,60,0.0134694326301322,1
"14468",0,686400,514860,171540,24,0.131757038203537,1
"14470",1,1248000,974800,273200,44,0.0109963089461401,1
"14485",1,1032000,797965,234035,47,0.0128268114953416,1
"14490",0,718800,495244,223556,51,0.016172752648917,1
"14492",0,444000,344841,99159,24,0.192822633289047,1
"14500",0,457200,366396,90804,48,0.0336277302153438,1
"14507",0,739200,596937,142263,33,0.0640874403155773,1
"14512",0,770400,512094,258306,23,0.120463876842658,1
"14517",0,501600,398390,103210,25,0.166066961377106,1
"14523",0,1142400,833740,308660,43,0.0140789516754147,1
"14537",0,604800,476859,127941,35,0.0692070122070865,1
"14538",0,444000,329373,114627,26,0.168420374953216,1
"14568",0,476400,394854,81546,23,0.197493745555188,1
"14572",0,1270800,1012483,258317,26,0.0429783136759902,1
"14574",0,519600,405982,113618,47,0.0323819705611816,1
"14583",0,385200,275276,109924,21,0.250727547154714,1
"14610",0,775200,564475,210725,35,0.0506568741987469,1
"14619",1,1155600,903115,252485,41,0.0164538510391116,1
"14620",0,672000,564956,107044,20,0.179956993700897,1
"14625",0,361200,246571,114629,20,0.273859403053332,1
"14641",0,447600,337385,110215,24,0.191156256410661,1
"14645",0,920400,653098,267302,25,0.0821599618382653,1
"14654",0,651600,518601,132999,21,0.172109526368545,1
"14667",0,861600,638672,222928,27,0.079334661235727,1
"14672",0,1216800,966016,250784,33,0.0276093909379692,1
"14675",1,895200,720554,174646,48,0.0153791385405593,1
"14676",0,610800,475207,135593,21,0.182380100001827,1
"14677",0,388800,277991,110809,23,0.220924714287885,1
"14694",0,1414800,1101406,313394,24,0.038470426769627,1
"14700",1,586800,500076,86724,49,0.0250118066353768,1
"14701",0,1040400,749847,290553,43,0.0169079479093776,1
"14702",0,1040400,780751,259649,21,0.0908944215564112,1
"14730",0,566400,390836,175564,23,0.16834106054269,1
"14786",0,567600,417024,150576,20,0.205677586518316,1
"14788",0,471600,359184,112416,21,0.223199666200552,1
"14805",1,914400,661002,253398,47,0.0155959191383349,1
"14806",0,409200,309247,99953,21,0.243647138673814,1
"14808",1,816000,620875,195125,31,0.0642750925809354,1
"14809",0,385200,279939,105261,21,0.251079059817076,1
"14813",0,427200,306931,120269,22,0.222368505846986,1
"14831",1,1368000,1009412,358588,47,0.00681379600352975,1
"14841",0,1236000,970494,265506,29,0.0361460597286412,1
"14842",0,657600,459998,197602,21,0.166981420280827,1
"14844",1,1114800,842103,272697,48,0.0101173773030603,1
"14854",0,955200,689982,265218,30,0.0536205758332871,1
"14856",0,450000,314939,135061,22,0.214535937176174,1
"14859",1,1191600,767867,423733,47,0.00902199414016435,1
"14877",1,847200,632655,214545,50,0.0140631546757355,1
"14882",0,682800,532157,150643,34,0.0650546718884053,1
"14884",1,619200,476681,142519,50,0.0214223083891173,1
"14889",0,362400,262941,99459,21,0.259111698414477,1
"14892",0,1309200,905849,403351,41,0.0118883502562688,1
"14916",0,1390800,1142712,248088,37,0.0150211601911944,1
"14924",0,651600,451668,199932,20,0.179733863653526,1
"14929",0,440400,318004,122396,24,0.192354218997764,1
"14942",0,370800,285517,85283,22,0.242491839874566,1
"14950",0,1203600,889955,313645,37,0.0202040546804831,1
"14959",1,6e+05,429819,170181,35,0.0686594471511952,1
"14975",1,572400,405675,166725,43,0.0394197034945779,1
"14988",0,502800,362034,140766,24,0.174872062731273,1
"14995",1,985200,775065,210135,26,0.0702140373380213,1
"14996",0,478800,371357,107443,24,0.183012663432564,1
"15006",0,468000,342383,125617,24,0.184758501250639,1
"15015",1,1430400,1114566,315834,50,0.00490548845577267,1
"15017",1,964800,725782,239018,31,0.0494317872370492,1
"15030",0,759600,626076,133524,24,0.119358596353344,1
"15042",1,760800,595605,165195,31,0.0711320118133089,1
"15046",0,1167600,880940,286660,26,0.0505134546061647,1
"15049",1,612000,496622,115378,32,0.0856315396188297,1
"15056",0,376800,283487,93313,23,0.22578905171831,1
"15076",1,424800,346853,77947,30,0.133971950789448,1
"15090",0,487200,343658,143542,23,0.19064558633992,1
"15104",0,382800,277128,105672,25,0.196770854828856,1
"15106",1,466800,375974,90826,35,0.0876830389394796,1
"15113",0,1356000,1099234,256766,30,0.0273964814881304,1
"15118",0,508800,398820,109980,22,0.199286239509525,1
"15121",1,1345200,1038665,306535,32,0.023442385471259,1
"15131",0,891600,675345,216255,52,0.0111246986978065,1
"15132",0,1108800,799749,309051,23,0.069054304963977,1
"15137",0,514800,384541,130259,22,0.196327533923232,1
"15148",0,780000,618620,161380,52,0.0137909333127601,1
"15177",0,373200,279718,93482,20,0.271372077706224,1
"15183",1,1423200,1055849,367351,39,0.011582043589383,1
"15189",0,492000,332436,159564,25,0.165267718953337,1
"15196",1,1183200,897691,285509,40,0.016745070534771,1
"15201",0,476400,369720,106680,51,0.0256672493569968,1
"15207",1,618000,502692,115308,37,0.0586414143117307,1
"15212",0,411600,346047,65553,42,0.0577845496473613,1
"15229",1,848400,658663,189737,42,0.0264257032274083,1
"15230",0,835200,623567,211633,23,0.110773827955039,1
"15231",0,993600,696525,297075,51,0.00976549849617287,1
"15233",0,1075200,816596,258604,33,0.0350047000112727,1
"15238",1,399600,315882,83718,33,0.112767420522264,1
"15241",0,1411200,1087014,324186,26,0.0330685855490194,1
"15246",0,423600,344068,79532,23,0.212702093517478,1
"15248",0,619200,480026,139174,20,0.192008051609677,1
"15252",0,1028400,792168,236232,29,0.0517646665051241,1
"15253",1,1174800,841005,333795,27,0.0454492122945744,1
"15266",1,936000,726141,209859,28,0.0656214150230748,1
"15278",0,384000,276231,107769,21,0.251285320660502,1
"15303",0,369600,280226,89374,24,0.214587420581986,1
"15313",0,482400,346142,136258,20,0.232159367693695,1
"15316",0,496800,357240,139560,22,0.200752136192576,1
"15326",1,936000,640414,295586,42,0.021826231754152,1
"15327",0,1166400,900627,265773,48,0.00927639016463729,1
"15341",0,429600,311483,118117,26,0.1717843696572,1
"15345",0,486000,343085,142915,25,0.16765284350869,1
"15385",0,729600,531571,198029,56,0.0108355820659024,1
"15391",1,967200,691110,276090,50,0.0111514638118724,1
"15396",0,411600,339089,72511,20,0.259889707161097,1
"15404",0,627600,461376,166224,52,0.0179019766358826,1
"15407",0,496800,361524,135276,25,0.16545146835411,1
"15420",0,1029600,737064,292536,24,0.0734160984169775,1
"15422",0,657600,515438,142162,39,0.0467561889243625,1
"15426",0,1324800,1003032,321768,25,0.0413382938039839,1
"15436",0,710400,584022,126378,27,0.104538869772031,1
"15437",1,939600,720154,219446,27,0.0700000474018636,1
"15439",0,364800,288485,76315,28,0.167755464428812,1
"15476",0,586800,422103,164697,45,0.0330355964040232,1
"15489",1,1429200,1184716,244484,25,0.0357199988427912,1
"15493",1,1260000,870948,389052,40,0.0140795158065117,1
"15509",0,408000,309917,98083,20,0.259130874035518,1
"15510",0,1371600,992157,379443,47,0.0067152196734879,1
"15513",1,1190400,803444,386956,31,0.0319511392163662,1
"15515",0,783600,581145,202455,55,0.0106554619391946,1
"15526",0,402000,299648,102352,35,0.0967957308182826,1
"15534",0,517200,338237,178963,20,0.218529001146016,1
"15538",0,988800,653549,335251,22,0.0893074465417081,1
"15549",0,418800,328228,90572,21,0.241248901668958,1
"15580",0,1334400,976150,358250,42,0.0107106931778199,1
"15582",0,427200,330085,97115,22,0.223978493479405,1
"15589",1,1383600,1115044,268556,43,0.00942036278008772,1
"15602",0,774000,595998,178002,25,0.107069432192823,1
"15610",1,489600,326037,163563,47,0.0334169294388457,1
"15611",0,664800,502841,161959,21,0.16721531962442,1
"15615",1,406800,336889,69911,28,0.158072703682151,1
"15628",0,782400,588577,193823,40,0.0344313438359254,1
"15633",0,554400,420090,134310,21,0.197661972796413,1
"15635",0,428400,313554,114846,25,0.183895407187722,1
"15637",0,894000,708106,185894,41,0.0264537438154199,1
"15640",0,824400,606236,218164,50,0.0146070281164281,1
"15646",0,520800,408386,112414,20,0.222030015298099,1
"15647",0,556800,456511,100289,22,0.186794430964759,1
"15650",1,526800,385353,141447,35,0.0781546441873795,1
"15653",0,1222800,878642,344158,32,0.0284672414035616,1
"15668",1,1066800,838482,228318,34,0.0332713929834725,1
"15681",1,474000,359859,114141,41,0.0551542708219063,1
"15683",1,775200,589425,185775,34,0.0551356580482012,1
"15685",0,476400,344856,131544,23,0.194334781217365,1
"15691",0,450000,338514,111486,21,0.229896046492944,1
"15693",1,739200,529331,209869,35,0.0537951140799841,1
"15696",0,441600,317214,124386,21,0.23159005259537,1
"15700",0,369600,282254,87346,20,0.273109355135419,1
"15712",1,1256400,975906,280494,31,0.029770535961213,1
"15713",0,375600,235180,140420,22,0.236928977082463,1
"15727",1,1400400,986698,413702,27,0.0301204381616321,1
"15760",0,632400,513414,118986,20,0.189686964223797,1
"15763",0,484800,357829,126971,25,0.168841959356116,1
"15768",1,1158000,832370,325630,46,0.0107571888319889,1
"15771",1,837600,595209,242391,44,0.0225829063030522,1
"15775",0,495600,362652,132948,25,0.165871129160365,1
"15779",1,1261200,911877,349323,31,0.0287476734346276,1
"15780",1,890400,601623,288777,30,0.0591546401532488,1
"15781",0,624000,487740,136260,20,0.190887130252745,1
"15822",0,535200,364249,170951,24,0.165155445578433,1
"15833",1,1048800,762470,286330,30,0.0455130555843931,1
"15879",0,572400,454742,117658,38,0.0586143412569094,1
"15889",0,1245600,925508,320092,24,0.0509379068001497,1
"15901",1,710400,561643,148757,44,0.0291052781139484,1
"15907",0,408000,327228,80772,21,0.245456840614057,1
"15913",0,1264800,949434,315366,43,0.0113621333841992,1
"15916",0,1366800,975258,391542,20,0.0547794270840584,1
"15921",0,1221600,905441,316159,21,0.0664274727646844,1
"15928",0,884400,583746,300654,37,0.0349932238844517,1
"15939",0,433200,328093,105107,26,0.171629416968538,1
"15942",0,1123200,856248,266952,21,0.0793825901440093,1
"15963",0,597600,456580,141020,22,0.173819302059851,1
"15967",0,364800,268852,95948,35,0.102882502361584,1
"15969",0,566400,428700,137700,22,0.182008258113446,1
"15971",1,786000,615495,170505,32,0.0632598261838926,1
"15985",0,373200,292219,80981,27,0.176714976388408,1
"15989",1,1226400,912361,314039,43,0.0121496712351603,1
"15991",0,656400,465882,190518,36,0.0576555093214451,1
"15993",1,1002000,744006,257994,28,0.0578165945119939,1
"15995",0,992400,737632,254768,53,0.00850210920290199,1
"16003",0,774000,560077,213923,25,0.105699800271982,1
"16026",1,826800,621857,204943,37,0.0400146648321607,1
"16032",1,925200,667813,257387,46,0.0165268167039479,1
"16040",0,1437600,1013348,424252,27,0.0281575707655755,1
"16044",0,387600,289357,98243,20,0.266039169330501,1
"16047",0,410400,308575,101825,20,0.258036953947335,1
"16055",0,626400,435383,191017,52,0.0177646318507022,1
"16057",0,1000800,710748,290052,43,0.0181043125004998,1
"16059",0,380400,300852,79548,22,0.23983465840338,1
"16061",1,631200,469576,161624,38,0.0523005367004036,1
"16065",0,378000,278382,99618,26,0.186152671332224,1
"16068",0,372000,291102,80898,26,0.188898276538292,1
"16071",0,465600,310465,155135,20,0.236079687956517,1
"16079",1,576000,396489,179511,32,0.0886018684877947,1
"16089",1,1203600,878059,325541,45,0.010752759629777,1
"16113",1,464400,360732,103668,42,0.0521876571266266,1
"16132",1,1011600,690031,321569,50,0.0101407147581075,1
"16164",0,1023600,763035,260565,47,0.0128785378918311,1
"16169",1,766800,617673,149127,37,0.0452105930819016,1
"16179",0,1020000,668619,351381,22,0.084458501073835,1
"16181",1,1125600,839724,285876,41,0.0170999059686407,1
"16207",0,506400,375405,130995,31,0.10813075924648,1
"16211",0,1334400,937301,397099,47,0.00711404880782905,1
"16213",0,708000,519275,188725,41,0.0362360210170464,1
"16233",0,645600,474408,171192,22,0.160434413454944,1
"16237",0,1321200,1011887,309313,40,0.0130722981356441,1
"16241",0,664800,495062,169738,20,0.178115288003065,1
"16261",0,962400,711793,250607,39,0.0267929278379788,1
"16266",0,442800,318588,124212,52,0.0249858586032441,1
"16269",1,650400,485128,165272,25,0.130180230183755,1
"16280",0,399600,295057,104543,20,0.261465764810687,1
"16285",1,1324800,1002575,322225,41,0.0119496526515612,1
"16286",0,883200,737808,145392,32,0.0544035162031537,1
"16299",0,576000,440502,135498,22,0.179647555870109,1
"16307",1,1063200,815229,247971,26,0.0609253785853291,1
"16318",0,424800,316944,107856,23,0.210456348070186,1
"16381",1,1323600,992972,330628,34,0.0206293911784282,1
"16394",0,512400,414420,97980,47,0.0329790259355314,1
"16405",0,9e+05,702763,197237,44,0.0206547121670378,1
"16413",0,523200,365572,157628,31,0.104322296319483,1
"16414",0,586800,463294,123506,21,0.189477877179723,1
"16416",1,752400,592330,160070,28,0.089943507807941,1
"16447",1,1125600,798606,326994,44,0.0133045252655971,1
"16452",0,664800,519375,145425,20,0.179547290838994,1
"16464",0,392400,297445,94955,24,0.207562978913499,1
"16472",0,436800,322509,114291,25,0.181729983576335,1
"16505",0,493200,393276,99924,21,0.217558454262577,1
"16507",1,1234800,871003,363797,40,0.0148532403959738,1
"16520",1,1051200,809326,241874,28,0.053623049307371,1
"16525",0,376800,280989,95811,21,0.254575250538897,1
"16528",0,883200,688419,194781,39,0.031331393206406,1
"16541",0,1138800,822546,316254,20,0.0817781774799401,1
"16567",1,830400,700184,130216,49,0.0161853276209628,1
"16568",1,507600,347091,160509,37,0.0691010699441773,1
"16569",0,481200,348812,132388,22,0.205643080522269,1
"16594",1,1332000,1009845,322155,49,0.00628572786851635,1
"16606",0,730800,510522,220278,20,0.159081483722299,1
"16642",1,1328400,1001594,326806,40,0.0128214338656536,1
"16643",0,524400,379607,144793,23,0.18071651122491,1
"16655",0,1348800,942292,406508,37,0.0151705673180362,1
"16658",0,378000,300497,77503,27,0.175696683148365,1
"16673",0,1140000,924802,215198,30,0.0401391368684845,1
"16687",0,525600,332632,192968,21,0.201968268365235,1
"16703",1,1365600,943099,422501,32,0.0216313579562934,1
"16704",0,993600,801068,192532,29,0.055756258657288,1
"16706",0,379200,297776,81424,23,0.225887555196661,1
"16709",0,644400,485262,159138,21,0.172413418971372,1
"16711",0,453600,350869,102731,24,0.189997646520045,1
"16718",0,711600,530744,180856,23,0.135408895043697,1
"16720",1,896400,725790,170610,46,0.0179713604938,1
"16734",0,686400,540922,145478,20,0.174036687890457,1
"16747",1,614400,473062,141338,46,0.0294545792735236,1
"16748",0,610800,512189,98611,22,0.172942431022571,1
"16750",0,633600,506039,127561,22,0.165691631755434,1
"16783",1,1437600,1061106,376494,50,0.0047284051543037,1
"16788",0,570000,407690,162310,54,0.0169369326580508,1
"16789",0,1048800,848777,200023,24,0.0736521474819166,1
"16792",0,1306800,898130,408670,27,0.0353675205806149,1
"16793",0,1269600,974903,294697,50,0.00654642688097308,1
"16796",0,775200,555745,219455,44,0.0253527087314607,1
"16798",0,517200,389969,127231,23,0.183645457154747,1
"16814",0,1238400,962538,275862,32,0.0284688854274239,1
"16819",1,422400,323611,98789,47,0.0383836493947695,1
"16854",0,574800,420560,154240,52,0.0196957012175848,1
"16858",0,968400,673211,295189,38,0.0281567129249249,1
"16860",0,426000,305862,120138,24,0.196447208441379,1
"16863",1,682800,500556,182244,47,0.0238763077589897,1
"16867",0,1071600,790654,280946,54,0.00677571275628236,1
"16868",0,520800,402747,118053,51,0.0236861939761891,1
"16877",0,454800,331121,123679,24,0.188386304488831,1
"16885",0,612000,470451,141549,22,0.170195883495446,1
"16886",1,1333200,935982,397218,45,0.00834591550255894,1
"16892",0,704400,502145,202255,43,0.0311046522383753,1
"16908",0,1051200,770968,280232,38,0.0245908264960071,1
"16910",0,974400,738209,236191,38,0.028518799294579,1
"16915",0,1338000,988959,349041,34,0.0199806379343322,1
"16917",0,508800,388824,119976,22,0.198647257922211,1
"16926",1,877200,660687,216513,32,0.0534842809386986,1
"16938",0,411600,323743,87857,22,0.229420854933909,1
"16946",0,448800,330673,118127,21,0.229796730033872,1
"16948",1,670800,481460,189340,41,0.0385731760200889,1
"16954",0,1143600,815487,328113,24,0.0601222486436898,1
"16962",0,907200,609803,297397,57,0.00707213091596218,1
"16976",1,463200,391288,71912,38,0.0713127762802969,1
"16977",0,524400,384711,139689,24,0.16953911234258,1
"16978",0,1255200,913778,341422,38,0.0169156812215733,1
"16979",0,1088400,808908,279492,42,0.0169042799893118,1
"16983",0,1076400,779219,297181,21,0.0846414688008414,1
"16994",0,1053600,741024,312576,27,0.0560525699419164,1
"17007",0,1282800,1026208,256592,20,0.0661864195566349,1
"17008",0,394800,278609,116191,23,0.218751498491875,1
"17017",1,376800,256404,120396,49,0.0352759104825424,1
"17023",1,932400,650830,281570,49,0.0127832792037848,1
"17034",0,9e+05,631938,268062,38,0.0319631922654489,1
"17038",0,1244400,857178,387222,29,0.033996583219007,1
"17040",0,1416000,1094104,321896,20,0.0518394097443352,1
"17041",0,1208400,981705,226695,41,0.015175637700113,1
"17047",0,541200,479185,62015,22,0.193365023266067,1
"17053",0,508800,402195,106605,22,0.199502330414072,1
"17061",0,415200,305351,109849,20,0.255816933993811,1
"17062",0,410400,331137,79263,22,0.230403389584952,1
"17064",1,981600,649062,332538,28,0.0581358008104083,1
"17067",1,739200,608000,131200,28,0.092825115538823,1
"17074",1,936000,686890,249110,27,0.0696370058315002,1
"17115",1,1257600,930558,327042,45,0.00978571974741138,1
"17138",0,866400,652933,213467,53,0.0107549805293159,1
"17153",0,1056000,791875,264125,26,0.0612773911428051,1
"17166",0,786000,592684,193316,25,0.104499674210304,1
"17178",0,483600,354315,129285,39,0.0626851779031887,1
"17213",1,781200,619348,161852,34,0.0550878772520437,1
"17215",1,1002000,758639,243361,32,0.0429906750503667,1
"17224",0,589200,455726,133474,22,0.17638224219392,1
"17226",0,631200,519508,111692,22,0.167157943825037,1
"17227",0,1274400,948924,325476,26,0.0416315463709635,1
"17240",0,740400,551023,189377,42,0.0317601969292502,1
"17245",0,439200,307888,131312,20,0.246292644482086,1
"17248",1,884400,616732,267668,50,0.0129130624178858,1
"17254",1,1404000,1005920,398080,40,0.0109351458874243,1
"17266",0,372000,272842,99158,23,0.226851160464574,1
"17269",0,492000,374635,117365,23,0.190968127940738,1
"17272",0,444000,340501,103499,24,0.192551853776299,1
"17275",0,589200,405202,183998,40,0.0478202873272921,1
"17284",1,1198800,897991,300809,30,0.035168699834127,1
"17299",0,411600,339747,71853,20,0.259940472850522,1
"17302",0,718800,529728,189072,46,0.0241960314833269,1
"17308",1,1261200,958380,302820,35,0.0214750852103722,1
"17319",0,889200,727094,162106,36,0.0395294186415761,1
"17320",1,772800,605735,167065,40,0.0353591844589426,1
"17333",0,1138800,836020,302780,46,0.0112223675789862,1
"17338",1,1119600,844275,275325,26,0.0549385507870198,1
"17342",0,974400,721622,252778,30,0.052185132717354,1
"17350",1,913200,757829,155371,33,0.047816082041075,1
"17360",0,752400,493792,258608,35,0.0516637657656021,1
"17371",0,1134000,865668,268332,29,0.0428690042462877,1
"17375",0,793200,593827,199373,60,0.00707721430016432,1
"17391",0,590400,468959,121441,58,0.0121487897963026,1
"17408",0,430800,357532,73268,26,0.174056273556705,1
"17413",0,626400,491023,135377,20,0.190293072210057,1
"17430",1,1116000,808238,307762,26,0.0545916022116489,1
"17432",0,656400,488147,168253,21,0.168920176656672,1
"17433",0,567600,439572,128028,23,0.170729332531783,1
"17437",0,477600,359973,117627,20,0.235002657945118,1
"17445",1,757200,589104,168096,39,0.0391719429595856,1
"17457",1,416400,295377,121023,34,0.100958383079156,1
"17462",0,612000,470703,141297,60,0.00992229573917838,1
"17467",0,408000,321626,86374,26,0.179100043593273,1
"17471",1,931200,700831,230369,46,0.0165320804038598,1
"17495",1,369600,263167,106433,42,0.0609782985945005,1
"17508",0,439200,331426,107774,24,0.193594977341921,1
"17519",0,685200,522830,162370,20,0.173366044037842,1
"17529",1,1252800,1013758,239042,38,0.0176851568610553,1
"17531",0,1236000,796559,439441,48,0.00767133280959076,1
"17537",1,619200,465469,153731,35,0.066950245333305,1
"17539",0,549600,394627,154973,20,0.21058456886977,1
"17541",0,534000,379778,154222,22,0.189592706385566,1
"17543",0,542400,404728,137672,24,0.165256458726024,1
"17551",0,464400,362719,101681,20,0.240351716480756,1
"17554",1,464400,320043,144357,25,0.172917878208903,1
"17577",0,421200,291002,130198,25,0.184866548012298,1
"17582",1,1302000,1054452,247548,27,0.0379454942292293,1
"17586",0,367200,258448,108752,55,0.0226692954577573,1
"17588",1,891600,637334,254266,50,0.0128211059150358,1
"17599",1,878400,647673,230727,29,0.0664296914589454,1
"17632",1,896400,688458,207942,29,0.0650539852713718,1
"17635",0,1273200,886128,387072,39,0.0148946777520459,1
"17641",0,615600,434711,180889,21,0.178450345143412,1
"17645",1,450000,328920,121080,44,0.0456532923308826,1
"17652",1,1303200,1010411,292789,31,0.0273597073801476,1
"17659",0,534000,433170,100830,25,0.158480790951263,1
"17661",0,524400,382807,141593,45,0.0370412468909112,1
"17666",0,522000,379332,142668,22,0.193566617145884,1
"17671",1,387600,298915,88685,32,0.123002121725595,1
"17703",1,807600,663427,144173,41,0.0311458568110314,1
"17719",1,1101600,877599,224001,26,0.0577084114881268,1
"17720",0,483600,329135,154465,20,0.230487046408071,1
"17725",1,1042800,771680,271120,40,0.0214363300430019,1
"17735",0,567600,403700,163900,20,0.204805888250979,1
"17758",0,420000,299154,120846,23,0.210988573771928,1
"17769",0,946800,740148,206652,45,0.0175644308980241,1
"17781",1,696000,492428,203572,45,0.0270275987081923,1
"17789",0,567600,449530,118070,49,0.0255307501036259,1
"17795",0,1136400,880433,255967,41,0.0169838731326426,1
"17808",0,626400,439869,186531,23,0.153559089512526,1
"17828",0,484800,334168,150632,23,0.190855735133586,1
"17852",1,973200,789218,183982,31,0.0497785916685818,1
"17856",1,477600,383792,93808,34,0.0925462583592423,1
"17866",0,1374000,1030909,343091,20,0.0551335081958946,1
"17867",0,529200,399820,129380,32,0.0972007219723461,1
"17870",0,1318800,953149,365651,37,0.0162358987331355,1
"17871",0,571200,455109,116091,23,0.170514257239972,1
"17881",1,1326000,1025699,300301,28,0.033067665153669,1
"17898",0,1090800,803055,287745,26,0.0573481938592191,1
"17902",1,793200,620502,172698,44,0.0250387149078877,1
"17912",0,567600,444493,123107,22,0.182567295369558,1
"17922",1,451200,356481,94719,46,0.0395297922632934,1
"17924",0,590400,434860,155540,20,0.198910384649917,1
"17925",1,1032000,776122,255878,29,0.0510726995536986,1
"17927",0,1189200,834316,354884,45,0.0108968966569301,1
"17928",0,1321200,1079939,241261,23,0.0499133708550375,1
"17932",0,603600,494739,108861,22,0.174162177075992,1
"17959",1,524400,415104,109296,44,0.0404817097294057,1
"17970",0,439200,345217,93983,24,0.19445996514969,1
"17983",0,670800,495098,175702,21,0.164995703003948,1
"17992",0,804000,588020,215980,35,0.048187726261417,1
"17994",0,445200,357671,87529,20,0.247603303891869,1
"17999",0,410400,287090,123310,59,0.0153205953924753,1
"18001",0,385200,283468,101732,20,0.266587370014549,1
"18003",1,768000,580475,187525,34,0.0557595850777959,1
"18009",0,523200,408251,114949,20,0.221129353342382,1
"18013",1,1162800,863745,299055,27,0.0469901763075057,1
"18018",0,403200,304826,98374,26,0.1796295128643,1
"18058",0,673200,508878,164322,37,0.0525376393589645,1
"18062",0,783600,588348,195252,49,0.0171001692912332,1
"18068",0,483600,381770,101830,20,0.234252612342837,1
"18073",0,842400,622343,220057,44,0.0225949977897001,1
"18074",0,922800,674265,248535,22,0.102320607053176,1
"18075",1,972000,622471,349529,43,0.01858337826968,1
"18091",1,908400,615729,292671,26,0.077133382928759,1
"18107",0,966000,754940,211060,21,0.104058827124823,1
"18116",1,860400,654623,205777,25,0.0924943159677702,1
"18123",1,1338000,1073369,264631,39,0.0139783042091616,1
"18125",1,428400,327606,100794,43,0.0514401466606231,1
"18135",0,520800,382980,137820,21,0.206933611530695,1
"18151",1,1098000,933108,164892,44,0.0148779779084025,1
"18176",1,1372800,964236,408564,38,0.0134474120130696,1
"18177",1,942000,693728,248272,44,0.0188354755327687,1
"18182",1,621600,477377,144223,45,0.0313910746016691,1
"18188",0,1196400,842920,353480,31,0.0320413921898554,1
"18198",1,1321200,946802,374398,29,0.0299934130212305,1
"18199",0,415200,318957,96243,25,0.188530597372914,1
"18205",0,391200,271343,119857,41,0.0630851923450806,1
"18212",0,679200,496989,182211,20,0.17373247257287,1
"18231",1,1072800,805331,267469,30,0.0440382074913662,1
"18239",0,406800,276991,129809,54,0.0227051049568362,1
"18263",0,385200,293801,91399,22,0.237443033821205,1
"18269",1,796800,633547,163253,29,0.0777843802810538,1
"18271",0,1003200,722373,280827,25,0.0715012961879387,1
"18286",0,806400,585414,220986,30,0.069638358456934,1
"18295",0,458400,363350,95050,24,0.189178818104881,1
"18300",1,678000,482553,195447,50,0.0189667457114116,1
"18308",0,391200,282917,108283,21,0.248880815290509,1
"18320",1,841200,561527,279673,28,0.0746140775255706,1
"18327",1,469200,334587,134613,37,0.0742673862439342,1
"18331",1,1180800,910151,270649,37,0.021367851151765,1
"18336",1,1353600,1011875,341725,25,0.0390824993933664,1
"18338",0,1082400,854701,227699,23,0.0743010747268694,1
"18350",1,1137600,801303,336297,47,0.010258422886799,1
"18360",0,1108800,844922,263878,48,0.0102590582871635,1
"18361",0,379200,276855,102345,21,0.253282132095354,1
"18363",1,452400,338602,113798,43,0.0491821396955211,1
"18371",0,433200,342590,90610,49,0.0324359696627327,1
"18373",0,610800,413125,197675,20,0.190654847044737,1
"18378",0,403200,282250,120950,37,0.0830359168379793,1
"18386",1,686400,529702,156698,32,0.0748057658838321,1
"18396",0,440400,357059,83341,25,0.182639718726691,1
"18405",0,856800,612014,244786,28,0.073698186733419,1
"18421",1,868800,696908,171892,28,0.0742607022541459,1
"18437",1,741600,524804,216796,38,0.0425908702523509,1
"18444",1,1053600,854369,199231,32,0.0400966997392226,1
"18446",0,573600,441880,131720,24,0.158170460928323,1
"18461",0,625200,461063,164137,55,0.014230023221618,1
"18464",1,1080000,858840,221160,43,0.0162309715787696,1
"18465",1,602400,463811,138589,45,0.0325011941421098,1
"18481",0,1076400,772243,304157,40,0.0199745473672556,1
"18487",1,841200,662189,179011,42,0.0268644404108171,1
"18502",0,895200,643218,251982,34,0.0440217693148192,1
"18504",0,570000,421170,148830,22,0.180410061621497,1
"18512",0,1068000,773538,294462,57,0.00535126595592028,1
"18514",0,510000,386002,123998,21,0.210977638364577,1
"18516",0,404400,280639,123761,27,0.166506989779853,1
"18535",1,1183200,928527,254673,43,0.0134037299043847,1
"18537",1,565200,376925,188275,25,0.146876353088586,1
"18544",1,1030800,738352,292448,50,0.00992263331420117,1
"18551",1,1315200,907370,407830,36,0.0173727445397905,1
"18558",1,1434000,1203727,230273,41,0.0102570449789955,1
"18566",0,968400,691954,276446,37,0.0306364982379373,1
"18570",1,1028400,694263,334137,47,0.0124052918897265,1
"18575",1,654000,510525,143475,30,0.0916086280071139,1
"18580",0,534000,397769,136231,20,0.216436381957181,1
"18617",0,1056000,881971,174029,45,0.0147390860788005,1
"18625",1,1436400,1123805,312595,26,0.0318284799395109,1
"18627",1,1123200,832528,290672,29,0.0432796461356698,1
"18629",0,1318800,935608,383192,36,0.0174338658896,1
"18641",1,1117200,778274,338926,38,0.021464364638602,1
"18646",0,498000,355410,142590,23,0.187801134351802,1
"18653",0,594000,458978,135022,20,0.19921679286728,1
"18655",0,562800,424947,137853,21,0.195114998345532,1
"18667",0,786000,574079,211921,39,0.0366899477854681,1
"18669",0,1311600,974072,337528,39,0.0142148102151275,1
"18671",0,590400,457614,132786,23,0.164884702518355,1
"18677",1,576000,404621,171379,48,0.0266315917001899,1
"18688",0,608400,493392,115008,20,0.196486601947976,1
"18689",0,1027200,787683,239517,45,0.0150945913027149,1
"18705",0,386400,270596,115804,23,0.221303886859153,1
"18723",1,775200,653670,121530,29,0.0817909258505432,1
"18745",0,1252800,871045,381755,22,0.0571446891246412,1
"18755",0,398400,294667,103733,22,0.232397258771479,1
"18757",0,1160400,829197,331203,54,0.00568990598299346,1
"18764",1,974400,681575,292825,46,0.0149714909538613,1
"18804",0,422400,309038,113362,40,0.0647231856895618,1
"18821",1,852000,686198,165802,32,0.0568447138150164,1
"18852",0,372000,268125,103875,27,0.175687313296642,1
"18854",1,1143600,919388,224212,31,0.0368340479608372,1
"18855",0,704400,537312,167088,47,0.0231470404092931,1
"18861",0,510000,378046,131954,24,0.173565644931252,1
"18865",0,447600,346674,100926,33,0.103978318242871,1
"18875",0,372000,289080,82920,20,0.272627244735941,1
"18880",0,644400,481839,162561,56,0.0127357984045592,1
"18888",0,685200,542601,142599,39,0.04464002741813,1
"18898",0,654000,502489,151511,58,0.0107526039833045,1
"18903",0,555600,476074,79526,23,0.176536907750223,1
"18905",1,1063200,824099,239101,50,0.00958109301749315,1
"18916",0,489600,345535,144065,24,0.178040616585094,1
"18919",1,862800,630528,232272,45,0.020089611913444,1
"18922",0,901200,653043,248157,29,0.0635772790670754,1
"18926",1,499200,396268,102932,44,0.0423353287190938,1
"18928",0,404400,307580,96820,42,0.0577886077241084,1
"18941",0,475200,358418,116782,23,0.195594055686992,1
"18943",0,1420800,1097403,323397,37,0.0138444702050589,1
"18951",1,416400,323220,93180,30,0.134973828090257,1
"18957",0,1046400,832829,213571,55,0.00672029688252563,1
"18962",0,408000,289175,118825,25,0.189075514703002,1
"18969",0,396000,305079,90921,22,0.234068231942421,1
"18973",1,524400,381989,142411,37,0.0676881015082736,1
"18988",1,1240800,931687,309113,40,0.0150212753225759,1
"18995",0,387600,302322,85278,54,0.0238764195837512,1
"18998",0,602400,466117,136283,22,0.172886387898343,1
"19028",0,634800,453425,181375,21,0.173543755336854,1
"19032",0,480000,357149,122851,25,0.170258786548703,1
"19041",0,1174800,906727,268073,23,0.0629432236200268,1
"19042",0,1282800,921937,360863,30,0.0297981001104997,1
"19049",0,1248000,924618,323382,21,0.0634434857403043,1
"19052",1,1335600,1030299,305301,45,0.00862061365894294,1
"19057",0,1348800,948282,400518,27,0.0330453155177399,1
"19061",0,454800,371559,83241,21,0.230413145598025,1
"19064",0,434400,316520,117880,25,0.182141595929735,1
"19081",0,512400,342478,169922,30,0.113381148179127,1
"19086",0,398400,302788,95612,30,0.138582136105241,1
"19090",1,451200,339336,111864,38,0.0716447045692411,1
"19126",0,506400,413850,92550,21,0.214144521544866,1
"19127",1,1149600,949908,199692,33,0.0315730669522958,1
"19130",1,478800,354776,124024,50,0.027431334676894,1
"19138",1,529200,388502,140698,25,0.157472475990348,1
"19178",1,640800,492820,147980,32,0.0807859153484807,1
"19196",1,1179600,922060,257540,44,0.0124560576763833,1
"19205",0,987600,634677,352923,20,0.102641007406016,1
"19208",1,362400,306057,56343,38,0.0844132658060332,1
"19211",0,601200,470848,130352,21,0.185218709982958,1
"19216",1,1215600,921677,293923,34,0.0251789643600661,1
"19222",1,1285200,1014974,270226,42,0.0120777837009543,1
"19230",1,390000,286269,103731,40,0.0684917180584604,1
"19242",0,638400,422281,216119,20,0.182199495784379,1
"19252",0,847200,642125,205075,38,0.035815170235621,1
"19265",0,621600,456662,164938,53,0.0167379790134842,1
"19269",1,567600,405017,162583,31,0.0970995057844136,1
"19270",0,512400,399456,112944,22,0.198092732576212,1
"19283",0,1396800,1148978,247822,39,0.0127115204219791,1
"19285",0,639600,421448,218152,21,0.17024698900615,1
"19291",1,1318800,976797,342003,48,0.00690515932693557,1
"19293",0,570000,422737,147263,22,0.1805030106701,1
"19297",0,496800,335175,161625,20,0.225908057915217,1
"19299",0,511200,393748,117452,23,0.185819402597832,1
"19309",0,595200,436601,158599,21,0.185095487664971,1
"19327",1,1033200,846076,187124,50,0.0103033805568099,1
"19328",1,476400,338092,138308,35,0.084856193509621,1
"19334",0,802800,619495,183305,35,0.0488900552284388,1
"19338",1,1417200,943220,473980,36,0.014194943491275,1
"19347",0,1008000,770405,237595,33,0.039525797480425,1
"19349",0,866400,713451,152949,31,0.060112682652761,1
"19354",0,574800,381877,192923,54,0.0165958906564272,1
"19361",1,974400,665279,309121,46,0.0148754071740497,1
"19366",0,360000,281794,78206,20,0.277195101157555,1
"19367",0,494400,393071,101329,23,0.191312386299525,1
"19369",0,1213200,980082,233118,33,0.0279712393088925,1
"19374",0,1124400,875811,248589,55,0.00578555461961175,1
"19390",0,374400,303368,71032,23,0.22809457189668,1
"19414",1,399600,301150,98450,26,0.180556380513196,1
"19435",1,1244400,837716,406684,29,0.033741163949012,1
"19437",1,598800,437573,161227,33,0.0799604089861268,1
"19438",0,506400,388429,117971,21,0.212433695094079,1
"19446",1,776400,557782,218618,30,0.073186247007402,1
"19449",1,1105200,921588,183612,50,0.00910604617205777,1
"19458",0,742800,541035,201765,44,0.026979522720682,1
"19465",0,1410000,1068620,341380,26,0.0329156507279695,1
"19471",0,738000,554608,183392,48,0.0200883447051161,1
"19472",0,417600,306480,111120,25,0.186979357558568,1
"19485",0,481200,366251,114949,23,0.194060284010021,1
"19490",0,876000,582646,293354,45,0.0191731560423041,1
"19491",1,1320000,935001,384999,40,0.0127127564726478,1
"19499",0,720000,528549,191451,53,0.0139774258399851,1
"19500",0,508800,372026,136774,24,0.173589932388051,1
"19502",0,528000,381543,146457,20,0.2175256352334,1
"19507",1,531600,402251,129349,42,0.0462053989242268,1
"19534",0,360000,279888,80112,27,0.180156420329632,1
"19537",0,502800,349530,153270,21,0.211123280959874,1
"19553",0,729600,480290,249310,56,0.0106173363165403,1
"19568",1,1286400,940051,346349,41,0.0126492613042307,1
"19575",0,540000,405531,134469,26,0.145166707834906,1
"19586",1,367200,270599,96601,27,0.177333812062716,1
"19600",0,386400,274353,112047,26,0.183186161527675,1
"19604",0,554400,420519,133881,60,0.0109966850713213,1
"19612",0,393600,286696,106904,26,0.181612498930328,1
"19617",0,1184400,900454,283946,32,0.0311079271063553,1
"19618",1,404400,302394,102006,31,0.127902015476906,1
"19627",0,1098000,900695,197305,42,0.0171746629671653,1
"19631",0,1090800,767295,323505,26,0.0565777447032675,1
"19641",0,1275600,907792,367808,28,0.0350824195098986,1
"19649",1,994800,716002,278798,46,0.0145337742687963,1
"19656",1,409200,306627,102573,35,0.0956907635299755,1
"19658",0,577200,430809,146391,22,0.17869580148199,1
"19712",0,514800,346695,168105,22,0.193943535060497,1
"19716",0,1286400,1000671,285729,48,0.0074710627012206,1
"19734",0,777600,575973,201627,32,0.0633924095162832,1
"19743",0,531600,391350,140250,24,0.167738943526442,1
"19748",0,494400,380516,113884,23,0.190534535176304,1
"19772",0,9e+05,594823,305177,53,0.00978349639123336,1
"19773",0,696000,525927,170073,20,0.170234116535937,1
"19782",1,388800,293723,95077,26,0.183575711669937,1
"19786",0,752400,599234,153166,46,0.0231680058205792,1
"19808",0,445200,305715,139485,25,0.178067900965889,1
"19818",1,1340400,982767,357633,41,0.0114690750962059,1
"19825",0,1348800,980015,368785,29,0.0286806748503906,1
"19833",0,1311600,958601,352999,41,0.0120776604661189,1
"19844",0,488400,329657,158743,22,0.201881463734445,1
"19848",1,702000,530421,171579,36,0.0538507119430703,1
"19852",0,372000,303880,68120,25,0.20219750133169,1
"19855",0,393600,311762,81838,20,0.265271935020886,1
"19878",1,1141200,868857,272343,36,0.0246956865513911,1
"19886",1,1282800,992301,290499,39,0.0152196505584953,1
"19887",0,451200,352242,98958,24,0.190879246933959,1
"19899",0,366000,288773,77227,22,0.244636607511367,1
"19923",0,429600,322841,106759,20,0.251276494948932,1
"19934",0,640800,458906,181894,20,0.183622587078869,1
"19935",0,1046400,804776,241624,31,0.0430873480473909,1
"19958",0,540000,408156,131844,21,0.201853117735214,1
"19965",0,540000,378920,161080,21,0.199970565844395,1
"19978",1,505200,350166,155034,46,0.0352578443260899,1
"19979",0,654000,487903,166097,20,0.181118761734378,1
"19989",0,559200,437608,121592,23,0.173192505633673,1
"19992",0,843600,648874,194726,45,0.021071049925536,1
"20005",1,1287600,955903,331697,45,0.0092721260400287,1
"20009",0,466800,373746,93054,22,0.212422507239268,1
"20025",1,680400,486245,194155,29,0.0926845569243238,1
"20035",0,420000,341718,78282,43,0.0526112664609293,1
"20038",0,820800,588527,232273,27,0.0844253685577041,1
"20049",0,597600,501614,95986,22,0.176428453475961,1
"20052",1,986400,750292,236108,44,0.0175341959568182,1
"20054",0,459600,352916,106684,59,0.0141658642385071,1
"20056",0,655200,469534,185666,21,0.168235989736907,1
"20063",1,1390800,1030238,360562,50,0.00516311114387351,1
"20066",0,649200,504727,144473,31,0.0858350373481132,1
"20067",1,1228800,975118,253682,36,0.0214128166716081,1
"20069",0,1357200,1024448,332752,39,0.0131624907884507,1
"20081",0,404400,295359,109041,25,0.190649296760121,1
"20096",0,511200,389711,121489,22,0.1978823834373,1
"20101",1,1018800,791545,227255,46,0.0142307506308297,1
"20103",1,1425600,1053886,371714,26,0.0316812413577352,1
"20121",0,499200,373872,125328,22,0.200993424290494,1
"20124",1,1140000,883521,256479,42,0.0156068125349192,1
"20129",0,448800,363039,85761,20,0.246561810826968,1
"20138",0,859200,681849,177351,46,0.019107786140292,1
"20153",0,1428000,1149590,278410,21,0.0479070165367998,1
"20156",0,474000,366119,107881,21,0.222786227169825,1
"20167",0,603600,478102,125498,21,0.184878162112377,1
"20173",1,944400,670142,274258,30,0.0544021447637136,1
"20178",0,811200,658515,152685,27,0.0882700783528423,1
"20184",0,745200,568871,176329,20,0.158067011138128,1
"20188",0,482400,361205,121195,22,0.206033243473889,1
"20197",0,420000,331841,88159,26,0.175925865635991,1
"20200",1,1046400,700709,345691,33,0.0355331522672207,1
"20206",0,445200,328433,116767,25,0.179405407246581,1
"20207",0,500400,384898,115502,22,0.201288840121141,1
"20213",0,846000,657787,188213,22,0.117850284400273,1
"20217",1,1153200,906291,246909,38,0.0209215417176528,1
"20218",0,624000,466223,157777,22,0.166342524392665,1
"20219",1,818400,595900,222500,35,0.0469265329048566,1
"20222",0,374400,273157,101243,22,0.240165012806889,1
"20241",0,657600,507895,149705,21,0.169670702449713,1
"20271",0,372000,265373,106627,22,0.240538507833718,1
"20272",0,1303200,967047,336153,22,0.0534872016799911,1
"20284",0,445200,355248,89952,25,0.180994206989104,1
"20290",0,705600,575735,129865,60,0.00847258957177869,1
"20292",0,864000,639332,224668,22,0.113135508939851,1
"20295",1,1117200,769963,347237,34,0.0291640225452694,1
"20315",1,841200,680432,160768,36,0.0428710726968675,1
"20316",1,940800,674956,265844,50,0.0117207384167929,1
"20350",0,432000,304768,127232,22,0.220437336540541,1
"20354",1,1153200,914380,238820,40,0.0179601670514667,1
"20356",0,595200,469453,125747,20,0.199474957563218,1
"20370",1,475200,350043,125157,43,0.0471422635877691,1
"20375",1,1352400,1024961,327439,48,0.00655086025387073,1
"20377",0,366000,281204,84796,24,0.215963147191787,1
"20397",0,734400,535282,199118,45,0.0253576190246246,1
"20406",1,447600,345824,101776,30,0.128331544337945,1
"20408",0,415200,322656,92544,20,0.257140504098972,1
"20432",0,639600,492304,147296,20,0.186030058243255,1
"20447",1,1359600,1059498,300102,47,0.00707706647202032,1
"20449",0,372000,313313,58687,24,0.215956241249403,1
"20456",1,394800,336010,58790,31,0.131760229290956,1
"20457",0,445200,339793,105407,26,0.16864394274675,1
"20483",0,367200,271568,95632,22,0.242888236908333,1
"20493",1,866400,609519,256881,37,0.0366894561971812,1
"20536",1,519600,420501,99099,42,0.0476888668626491,1
"20538",0,435600,298374,137226,21,0.232545754835463,1
"20550",1,726000,558017,167983,31,0.0751897033794433,1
"20551",0,640800,530626,110174,26,0.125659833956936,1
"20560",1,1238400,959279,279121,33,0.0263184941255616,1
"20564",1,1178400,793711,384689,48,0.00866566514197963,1
"20602",1,954000,650146,303854,26,0.0713370837519757,1
"20624",0,865200,651020,214180,42,0.0254347317338608,1
"20625",0,618000,468596,149404,22,0.168274943209772,1
"20634",0,480000,406753,73247,23,0.197022031017959,1
"20637",0,1058400,856467,201933,35,0.0315732254145943,1
"20638",0,930000,642856,287144,21,0.107133762114726,1
"20643",1,1371600,946101,425499,48,0.006092675101639,1
"20652",0,451200,323457,127743,25,0.177220145986259,1
"20668",1,429600,330269,99331,31,0.123173272452429,1
"20672",0,1381200,1089625,291575,40,0.0118663300486139,1
"20681",0,1033200,896522,136678,22,0.0894580684416368,1
"20692",0,418800,289315,129485,20,0.253126182503625,1
"20695",1,663600,476841,186759,41,0.0390826020268944,1
"20697",0,518400,409891,108509,23,0.184457386392266,1
"20717",0,369600,270720,98880,23,0.227609129187283,1
"20719",1,849600,679088,170512,49,0.0154111231918907,1
"20733",0,448800,334857,113943,37,0.0773520696901073,1
"20735",0,763200,573542,189658,26,0.100994115429414,1
"20740",1,492000,377508,114492,36,0.0776045809003915,1
"20761",0,535200,414910,120290,23,0.179373832235797,1
"20786",1,586800,364074,222726,28,0.114122379300383,1
"20790",0,505200,370566,134634,22,0.198715481333854,1
"20793",1,1176000,919858,256142,46,0.0107182311038888,1
"20820",0,1370400,1025796,344604,41,0.0109446134380264,1
"20822",1,708000,552503,155497,32,0.0722605650619029,1
"20823",1,1393200,1002742,390458,30,0.0244025783989247,1
"20828",1,687600,507746,179854,43,0.0322836111803049,1
"20832",1,565200,413178,152022,46,0.0318888434500225,1
"20837",0,1408800,1033141,375659,28,0.0278989425870405,1
"20838",0,472800,368113,104687,21,0.223372650166235,1
"20845",0,415200,311093,104107,26,0.176217986241066,1
"20849",1,510000,380131,129869,47,0.0327063327590327,1
"20870",1,1278000,908567,369433,45,0.00928761733525688,1
"20875",0,438000,335792,102208,25,0.182138344841311,1
"20880",0,493200,376079,117121,25,0.16733636395065,1
"20887",0,1251600,855473,396127,26,0.0420972847103475,1
"20897",0,942000,704613,237387,38,0.0301203748433163,1
"20907",0,376800,298639,78161,25,0.20019862073287,1
"20925",0,438000,333690,104310,20,0.248701204873437,1
"20936",0,376800,314739,62061,24,0.214307709311653,1
"20946",0,552000,381382,170618,49,0.0256868748446063,1
"20952",0,992400,775892,216508,56,0.00681434061738287,1
"20957",0,1117200,819032,298168,24,0.0635003284579384,1
"20966",1,1266000,999083,266917,36,0.0199845943282971,1
"20969",1,778800,613009,165791,44,0.0257314236471406,1
"20972",0,462000,348883,113117,51,0.0262397783800538,1
"20983",0,757200,596420,160780,33,0.0617896543498448,1
"20989",0,531600,380956,150644,21,0.203011919114367,1
"20994",0,582000,423048,158952,20,0.20104605657968,1
"20995",1,806400,569762,236638,31,0.0642853238069018,1
"20996",1,1380000,1087363,292637,42,0.0101575971741953,1
"21008",0,446400,325792,120608,26,0.1674974905103,1
"21009",1,1177200,843944,333256,43,0.0131287721763776,1
"21011",0,871200,627684,243516,59,0.00656968899460959,1
"21015",1,1098000,774307,323693,35,0.028151971470904,1
"21018",0,798000,623685,174315,49,0.0168195354708917,1
"21025",0,638400,515655,122745,20,0.187846269403228,1
"21043",0,544800,421621,123179,23,0.176742601876262,1
"21055",0,711600,556332,155268,25,0.118932075631153,1
"21075",0,654000,463808,190192,20,0.179689857981053,1
"21077",0,411600,343090,68510,24,0.203799892339391,1
"21079",0,974400,751420,222980,55,0.00758850956883701,1
"21093",1,981600,734184,247416,37,0.030297269672316,1
"21094",0,717600,547983,169617,33,0.0657183679508533,1
"21103",0,1344000,1052485,291515,23,0.0471390163630663,1
"21118",0,1202400,931853,270547,40,0.0162960244072625,1
"21122",1,913200,640496,272704,27,0.0716381421413444,1
"21124",0,501600,399442,102158,37,0.0713148977974918,1
"21128",0,1304400,911933,392467,39,0.0140834145828001,1
"21134",1,1224000,968222,255778,27,0.0431255099423926,1
"21142",1,1293600,1030599,263001,36,0.019088542881702,1
"21148",0,411600,312574,99026,23,0.214922047663805,1
"21152",1,781200,634985,146215,50,0.0161907850323057,1
"21170",0,646800,428357,218443,20,0.179879227337213,1
"21171",1,542400,390389,152011,47,0.0306919478104545,1
"21180",1,774000,555122,218878,43,0.0274538147863681,1
"21184",1,783600,558075,225525,30,0.0721494854315777,1
"21196",1,1022400,752990,269410,49,0.0109916885871372,1
"21207",0,498000,418165,79835,44,0.0427985566771669,1
"21217",0,754800,623121,131679,25,0.112165313562591,1
"21230",1,1437600,1131115,306485,50,0.00486240201964536,1
"21236",0,884400,663082,221318,54,0.00960610932050185,1
"21241",0,376800,280682,96118,49,0.0356087937030824,1
"21244",0,578400,434119,144281,37,0.0619125452103152,1
"21247",0,711600,512686,198914,57,0.0103303392442505,1
"21256",0,526800,398234,128566,52,0.0216033966186108,1
"21262",0,554400,416794,137606,21,0.197452404563965,1
"21272",0,380400,306959,73441,25,0.199492717219218,1
"21275",0,513600,410040,103560,22,0.198356752940953,1
"21291",0,519600,440943,78657,37,0.0698642510202705,1
"21293",0,460800,353592,107208,47,0.0358590583507314,1
"21308",0,1305600,1000275,305325,29,0.0316367299490508,1
"21360",0,537600,379287,158313,20,0.213875718008978,1
"21372",1,430800,332867,97933,30,0.13183674232997,1
"21377",0,540000,371267,168733,22,0.187095949257345,1
"21379",0,608400,461749,146651,21,0.182345789160249,1
"21381",0,363600,271605,91995,22,0.244319256722313,1
"21387",1,1228800,925824,302976,41,0.0142154338202625,1
"21390",0,1436400,1065269,371131,22,0.0422593811304563,1
"21414",1,925200,721781,203419,36,0.0366139969799985,1
"21415",0,400800,299431,101369,21,0.246264139707109,1
"21421",1,903600,665882,237718,44,0.0202035903327615,1
"21423",0,516000,403057,112943,28,0.132247995358858,1
"21435",0,496800,401888,94912,23,0.191060131078853,1
"21453",1,451200,331875,119325,43,0.0491767971517218,1
"21454",0,522000,399839,122161,40,0.0547453884965328,1
"21455",0,448800,323160,125640,26,0.166631499119063,1
"21458",0,391200,271206,119994,50,0.031886873215887,1
"21485",0,432000,303439,128561,45,0.0434859446477716,1
"21504",0,873600,685253,188347,24,0.0979470839776439,1
"21523",1,1142400,807244,335156,32,0.0327472221631466,1
"21528",1,750000,565262,184738,41,0.0338041889797034,1
"21534",1,1257600,844416,413184,29,0.0329121357915537,1
"21537",0,621600,464593,157007,21,0.178313457610087,1
"21546",1,753600,576196,177404,39,0.0392689481926905,1
"21557",0,375600,305653,69947,58,0.0179632892632995,1
"21560",0,546000,379969,166031,22,0.185666131030065,1
"21565",1,658800,485002,173798,41,0.0395968882685891,1
"21568",0,1371600,960461,411139,20,0.0539430631395338,1
"21574",1,1111200,825496,285704,36,0.0258585097230916,1
"21592",0,417600,293837,123763,45,0.0446295444929403,1
"21603",1,885600,717908,167692,37,0.036764870555574,1
"21616",0,465600,336447,129153,25,0.173490051728254,1
"21624",1,424800,318907,105893,33,0.10756805631421,1
"21626",0,1312800,928023,384777,20,0.0600427849424982,1
"21641",0,577200,450941,126259,21,0.191903260001152,1
"21643",1,1396800,1078730,318070,50,0.00519676137998866,1
"21647",0,1236000,958295,277705,33,0.0264410822833447,1
"21652",1,1238400,945806,292594,41,0.0140391650331381,1
"21658",0,585600,371457,214143,20,0.196516088052376,1
"21660",0,483600,372195,111405,20,0.233564441020884,1
"21664",0,500400,401997,98403,21,0.215521800579497,1
"21673",0,1375200,987426,387774,43,0.00911646370330157,1
"21674",0,688800,489664,199136,27,0.105352650073823,1
"21676",0,529200,408919,120281,22,0.192999655470556,1
"21677",1,609600,461117,148483,47,0.0274139071155153,1
"21683",0,841200,640220,200980,26,0.0888763891040539,1
"21700",1,916800,672846,243954,33,0.0459469138153841,1
"21717",0,478800,354619,124181,22,0.206870399564966,1
"21722",1,1003200,770928,232272,32,0.0430872601456186,1
"21725",0,654000,523874,130126,38,0.0509631203164352,1
"21735",1,804000,608872,195128,26,0.0944983381521474,1
"21738",0,638400,493661,144739,34,0.0701036105318062,1
"21743",0,565200,446504,118696,23,0.171857552025775,1
"21746",1,1112400,871757,240643,30,0.0416351389890049,1
"21760",0,417600,287964,129636,26,0.174130985302317,1
"21778",0,634800,500559,134241,21,0.176271916642374,1
"21787",0,1290000,1028947,261053,44,0.0102735636323465,1
"21789",0,966000,656868,309132,23,0.0869751607632378,1
"21798",0,628800,436251,192549,21,0.174410451845704,1
"21801",0,440400,330780,109620,21,0.23302120219251,1
"21808",0,727200,626748,100452,20,0.166489949880772,1
"21811",0,367200,272597,94603,21,0.257873020498978,1
"21821",1,1099200,827441,271759,34,0.030965960979367,1
"21832",0,514800,387596,127204,21,0.209368116798398,1
"21844",0,1036800,708337,328463,38,0.0247323977035475,1
"21847",1,463200,370734,92466,39,0.0657193174058065,1
"21855",0,496800,378216,118584,24,0.177690370611485,1
"21870",0,6e+05,479328,120672,46,0.0304280482413584,1
"21872",0,1327200,1062602,264598,40,0.0131683955784445,1
"21878",1,1050000,754426,295574,44,0.0153496092366467,1
"21890",1,970800,749941,220859,30,0.0531384598256258,1
"21908",0,756000,528730,227270,40,0.0355400036749243,1
"21909",1,1312800,977098,335702,33,0.0226682246508916,1
"21919",0,561600,418327,143273,21,0.195103795475197,1
"21920",1,738000,593305,144695,32,0.0690931993209911,1
"21931",1,1378800,1004186,374614,33,0.0199356746985395,1
"21936",0,1264800,1003148,261652,34,0.0234419968836133,1
"21939",0,862800,728037,134763,27,0.0817981400502228,1
"21941",0,433200,339636,93564,22,0.222402790622293,1
"21947",1,529200,413286,115914,33,0.0908942354720528,1
"21962",0,412800,295610,117190,22,0.226978482084032,1
"21970",1,933600,672223,261377,36,0.0352982019691174,1
"21981",1,884400,665571,218829,30,0.0613379716043474,1
"21989",0,361200,239809,121391,27,0.177416955098921,1
"21997",0,372000,263571,108429,26,0.187212255783406,1
"22011",0,712800,602764,110036,30,0.0844193718437074,1
"22034",1,1185600,896021,289579,37,0.0210357687239593,1
"22048",1,476400,325717,150683,36,0.0785270476600107,1
"22051",1,1168800,873762,295038,37,0.0216042310174167,1
"22065",1,1226400,929567,296833,35,0.0228480027096422,1
"22066",0,568800,438908,129892,22,0.181848503266508,1
"22072",1,1119600,812248,307352,32,0.0344050116238153,1
"22077",0,403200,292052,111148,25,0.19084339826267,1
"22097",0,480000,365514,114486,50,0.0274773394112274,1
"22109",1,1160400,828556,331844,49,0.00843918954715364,1
"22115",1,1316400,930388,386012,37,0.0161727478353738,1
"22125",1,444000,301670,142330,49,0.0312139052594325,1
"22142",0,847200,686306,160894,39,0.0337437118265346,1
"22147",1,628800,461911,166889,50,0.020871836546035,1
"22148",0,711600,539265,172335,23,0.135809504256567,1
"22152",0,444000,349350,94650,23,0.205785290776114,1
"22155",0,736800,545420,191380,27,0.0979594125089808,1
"22156",0,1006800,787277,219523,34,0.0369490486070283,1
"22157",0,1263600,859315,404285,43,0.0109912567921177,1
"22160",1,612000,448278,163722,35,0.0674899725080714,1
"22168",0,500400,367051,133349,24,0.175910475906441,1
"22169",1,949200,704684,244516,34,0.040323193770724,1
"22178",1,1015200,720194,295006,27,0.0601175554343598,1
"22196",0,360000,278156,81844,22,0.246240570918421,1
"22209",1,1204800,851488,353312,39,0.0169838845335953,1
"22224",1,1363200,1110844,252356,28,0.0316296120992294,1
"22226",0,424800,301232,123568,25,0.184317400377167,1
"22238",1,987600,690211,297389,43,0.0184666437829289,1
"22270",0,537600,373724,163876,58,0.0130889498523442,1
"22271",1,909600,765429,144171,35,0.0415076464809983,1
"22285",1,717600,512906,204694,30,0.0809032747262149,1
"22287",0,895200,643326,251874,32,0.0512164384212742,1
"22298",0,1100400,870192,230208,24,0.0669563283585976,1
"22299",0,590400,487897,102503,23,0.166563982073861,1
"22301",0,424800,323454,101346,25,0.185661163777318,1
"22302",1,764400,579021,185379,40,0.0356115068591086,1
"22305",0,708000,506873,201127,50,0.0179727870875123,1
"22311",0,448800,304022,144778,25,0.176837366215644,1
"22317",1,1328400,967595,360805,27,0.0347368089574136,1
"22320",0,639600,484350,155250,34,0.0696928450825579,1
"22322",0,675600,508022,167578,20,0.175487362369843,1
"22344",1,1252800,962665,290135,41,0.0137075022226787,1
"22351",0,446400,335339,111061,39,0.0670816697663307,1
"22358",0,734400,515777,218623,26,0.104575914979382,1
"22373",0,468000,365238,102762,24,0.186143205561889,1
"22377",0,462000,330809,131191,20,0.238961217759306,1
"22385",0,1333200,908619,424581,21,0.0530541871890951,1
"22389",0,524400,406548,117852,24,0.1707758267894,1
"22392",0,688800,534190,154610,49,0.0204518272276138,1
"22393",0,907200,663565,243635,40,0.0273212139903308,1
"22394",1,1438800,1020882,417918,44,0.00745429733999263,1
"22405",0,644400,520772,123628,41,0.0413580665689624,1
"22424",0,626400,443516,182884,37,0.0563749495190727,1
"22449",1,888000,627491,260509,47,0.0162764785034009,1
"22454",0,630000,484436,145564,20,0.188696799005075,1
"22456",0,618000,439808,178192,45,0.0311693652808676,1
"22459",1,426000,308132,117868,36,0.0861904278391044,1
"22460",1,1112400,900002,212398,46,0.0121757957280171,1
"22469",1,698400,481201,217199,26,0.110687528614929,1
"22474",0,382800,294372,88428,24,0.210778328440539,1
"22494",1,549600,448545,101055,43,0.0420077725540881,1
"22505",1,1393200,1012753,380447,38,0.01312667073669,1
"22508",1,872400,741834,130566,34,0.0479068008118013,1
"22513",0,1102800,847649,255151,39,0.021035660975631,1
"22548",1,1402800,1091411,311389,46,0.00707162995437793,1
"22564",1,1260000,1011837,248163,27,0.0407154991838376,1
"22568",1,729600,558026,171574,26,0.10715815089088,1
"22572",1,1236000,921802,314198,25,0.0481023524269327,1
"22580",0,1375200,1081003,294197,25,0.0383831855126505,1
"22583",1,1046400,730662,315738,47,0.0121127787556438,1
"22593",0,846000,634695,211305,32,0.0564312856704349,1
"22606",0,1153200,840806,312394,28,0.0440382129205973,1
"22612",0,517200,392891,124309,24,0.172200218336482,1
"22613",1,1294800,982875,311925,49,0.00673361366432535,1
"22624",1,862800,621765,241035,27,0.0786533331744011,1
"22627",0,496800,379852,116948,22,0.202211250306744,1
"22656",0,458400,325685,132715,25,0.175099955978581,1
"22661",1,1010400,780861,229539,33,0.0394888401132949,1
"22665",1,1225200,923875,301325,50,0.00705363808412248,1
"22688",0,999600,765728,233872,31,0.0467360812453017,1
"22693",0,643200,483867,159333,20,0.184349801968407,1
"22699",0,1356000,1066458,289542,40,0.0124053474566435,1
"22709",0,583200,396153,187047,22,0.174793619948442,1
"22718",1,735600,536909,198691,50,0.0171553477458324,1
"22732",1,417600,311967,105633,39,0.0704518357704988,1
"22745",0,492000,393868,98132,23,0.192162774076348,1
"22757",1,616800,499210,117590,29,0.105349841771227,1
"22759",0,481200,398536,82664,21,0.222353461183347,1
"22783",0,372000,276129,95871,45,0.0486782288373736,1
"22811",0,840000,625997,214003,49,0.0154016692892625,1
"22826",0,1254000,904311,349689,40,0.0144493024550736,1
"22828",0,1375200,884996,490204,24,0.038413801021919,1
"22831",0,415200,290983,124217,24,0.199190332176052,1
"22845",0,543600,392081,151519,22,0.187186710009983,1
"22850",0,558000,419377,138623,32,0.0925499744204932,1
"22864",0,631200,505818,125382,26,0.126842425815362,1
"22868",0,399600,310039,89561,21,0.247535685893415,1
"22872",0,675600,533262,142338,38,0.0489350362310263,1
"22878",0,572400,413936,158464,20,0.203793165799068,1
"22881",0,650400,490886,159514,26,0.121692388653636,1
"22882",0,375600,268880,106720,36,0.0937837757304797,1
"22885",0,375600,284681,90919,26,0.187321132225676,1
"22896",1,1306800,1001558,305242,45,0.00906294480795944,1
"22914",0,417600,333601,83999,21,0.242117395756798,1
"22934",0,448800,337503,111297,22,0.21650286047517,1
"22939",1,919200,640029,279171,45,0.0179000971414585,1
"22944",1,648000,482290,165710,43,0.0347125928165724,1
"22960",0,566400,417500,148900,57,0.0135487217678793,1
"22966",0,510000,362350,147650,24,0.172664489982984,1
"22967",0,1369200,863638,505562,34,0.0178060308948931,1
"22970",1,674400,537139,137261,27,0.110163779839204,1
"22974",0,693600,549730,143870,45,0.0277778100954762,1
"22983",0,1093200,786778,306422,50,0.00885480838729087,1
"22988",0,369600,280038,89562,22,0.24256280542249,1
"22995",0,384000,304122,79878,23,0.224528286106061,1
"22999",1,590400,458044,132356,50,0.0225959214684278,1
"23003",0,528000,359163,168837,24,0.167020089120612,1
"23008",1,1171200,873773,297427,44,0.0124403191253753,1
"23011",0,385200,294391,90809,26,0.184780670685922,1
"23017",0,364800,304101,60699,27,0.180064288418772,1
"23018",0,418800,342166,76634,26,0.17690295022289,1
"23022",0,949200,755892,193308,36,0.0352971258226861,1
"23024",0,633600,458927,174673,56,0.0129138606772968,1
"23026",0,405600,292876,112724,24,0.202630715713855,1
"23034",0,1105200,859622,245578,34,0.0309656036485668,1
"23036",0,640800,479690,161110,40,0.0442546022184474,1
"23037",0,654000,512188,141812,21,0.171009502155664,1
"23050",0,610800,426532,184268,21,0.179486970556306,1
"23058",1,1262400,902871,359529,40,0.0141859083352213,1
"23066",1,630000,490193,139807,41,0.0421075274986995,1
"23081",1,560400,424194,136206,33,0.0858361906426915,1
"23087",1,586800,444324,142476,48,0.0264422325239176,1
"23092",0,469200,349268,119932,53,0.0221368856095946,1
"23118",0,547200,394840,152360,54,0.0176842553239366,1
"23131",0,500400,400413,99987,24,0.177858662149243,1
"23139",0,612000,482199,129801,28,0.113428415082912,1
"23158",1,910800,658558,252242,50,0.012412181309955,1
"23162",1,748800,592547,156253,31,0.0727754219897412,1
"23164",0,1297200,1035330,261870,31,0.027976113205333,1
"23176",1,1074000,850524,223476,27,0.056052223019253,1
"23187",1,448800,288843,159957,50,0.0284677173537407,1
"23190",1,784800,664711,120089,42,0.0302580107291163,1
"23191",1,993600,776898,216702,45,0.0161399205094864,1
"23205",0,954000,683622,270378,30,0.0536222476135166,1
"23209",1,1045200,727566,317634,42,0.0179377548864377,1
"23245",1,1096800,872030,224770,40,0.0198983015397382,1
"23272",1,1023600,750631,272969,40,0.0221374146194134,1
"23292",0,560400,380029,180371,23,0.169546348809315,1
"23299",0,1232400,971273,261127,36,0.0212189394734765,1
"23303",0,447600,340163,107437,21,0.230929661516574,1
"23312",0,1104000,821815,282185,20,0.087560553494473,1
"23317",1,524400,446387,78013,28,0.132166779743635,1
"23319",0,522000,387004,134996,24,0.170397903272132,1
"23334",0,590400,443375,147025,20,0.199455139302217,1
"23358",1,850800,605862,244938,44,0.0220559626604951,1
"23359",0,432000,357639,74361,22,0.224102986316825,1
"23361",0,622800,447045,175755,31,0.0885172722703661,1
"23375",0,957600,676191,281409,37,0.0311433623276058,1
"23376",0,369600,294112,75488,22,0.243601409796147,1
"23385",1,1191600,891354,300246,41,0.0151746722523988,1
"23389",0,506400,377379,129021,20,0.225254120938793,1
"23413",1,394800,301213,93587,50,0.0320193792207957,1
"23422",0,463200,324970,138230,25,0.173571001083445,1
"23432",0,1315200,998602,316598,43,0.0104067247820852,1
"23444",0,592800,411184,181616,21,0.184338495199168,1
"23456",0,440400,353830,86570,23,0.207350224836758,1
"23464",0,585600,447044,138556,20,0.201347059084371,1
"23480",0,399600,286557,113043,24,0.204313761126644,1
"23486",0,1098000,790494,307506,34,0.0306009268157802,1
"23493",1,939600,745846,193754,49,0.013071730669422,1
"23496",0,1024800,802473,222327,36,0.0307058116929684,1
"23499",1,979200,738750,240450,26,0.0701066455353173,1
"23513",0,591600,450514,141086,20,0.199499771210367,1
"23553",0,404400,313349,91051,48,0.0367637516162085,1
"23571",0,439200,313381,125819,42,0.0539599927635579,1
"23580",0,543600,384913,158687,23,0.17498324022766,1
"23585",0,362400,258360,104040,21,0.25875913348789,1
"23609",0,922800,700401,222399,53,0.00971834651484728,1
"23617",0,368400,281924,86476,22,0.243177024518044,1
"23620",1,816000,594623,221377,43,0.0255309111162785,1
"23621",1,646800,409670,237130,44,0.0313311591298068,1
"23645",0,879600,645186,234414,23,0.102496233001508,1
"23646",0,577200,415294,161906,20,0.202209135919919,1
"23648",0,680400,564696,115704,59,0.00963058438714445,1
"23668",0,537600,418910,118690,36,0.0719625007368288,1
"23678",0,548400,404835,143565,51,0.0223684364513388,1
"23679",1,1239600,981006,258594,47,0.00886364810765853,1
"23686",1,879600,642292,237308,40,0.0287067854841056,1
"23691",0,943200,721110,222090,45,0.0175664271279654,1
"23724",0,420000,318550,101450,22,0.225874622195274,1
"23726",1,985200,783020,202180,36,0.0330970955753787,1
"23743",1,974400,768453,205947,37,0.0311684482049451,1
"23776",0,562800,413653,149147,20,0.207149094254257,1
"23781",1,852000,636457,215543,50,0.013941517328076,1
"23800",1,765600,593074,172526,34,0.056300166782418,1
"23803",0,879600,691772,187828,46,0.0183733173404232,1
"23817",0,415200,301908,113292,33,0.108905109389135,1
"23818",0,397200,307407,89793,24,0.206522154936676,1
"23820",0,1099200,820284,278916,28,0.0488173876449974,1
"23822",0,440400,335208,105192,25,0.181335043518692,1
"23827",0,482400,353641,128759,20,0.232695956591639,1
"23832",0,429600,352165,77435,24,0.198160783342959,1
"23849",0,494400,363995,130405,20,0.228846530972415,1
"23851",1,1287600,1039806,247794,46,0.00886079015145034,1
"23867",0,516000,375981,140019,20,0.221570584520929,1
"23872",0,373200,280568,92632,54,0.0244012463569878,1
"23881",0,640800,498916,141884,21,0.174309040353416,1
"23883",0,931200,681378,249822,40,0.0261623746764839,1
"23885",1,844800,668513,176287,30,0.0665079765162218,1
"23894",0,745200,552788,192412,40,0.0366852333561621,1
"23909",0,585600,469988,115612,29,0.110692468531898,1
"23914",0,414000,266728,147272,21,0.238635345972819,1
"23918",0,1186800,828830,357970,37,0.0204361176313172,1
"23919",0,548400,423986,124414,23,0.175754925585411,1
"23927",1,567600,439814,127786,48,0.0274791882166194,1
"23930",1,697200,490842,206358,49,0.0197531409835656,1
"23947",0,495600,354431,141169,23,0.188530555742694,1
"23950",0,452400,313675,138725,22,0.213581258661333,1
"23961",0,892800,682416,210384,56,0.00812281066301912,1
"23962",1,514800,415267,99533,37,0.0698666632986445,1
"23969",0,1369200,1121833,247367,37,0.0155959408813847,1
"23973",0,386400,293898,92502,20,0.266900209448066,1
"23977",1,818400,656786,161614,27,0.0869752829957214,1
"23984",0,451200,332988,118212,56,0.018088444902976,1
"23985",0,1083600,893617,189983,41,0.0190886985770407,1
"24000",0,417600,310153,107447,25,0.187203409004578,1
"24011",1,1222800,897442,325358,32,0.0286765258033255,1
"24012",0,390000,301382,88618,22,0.23612476366639,1
"24017",0,1312800,902981,409819,24,0.0439988501514837,1
"24032",0,1285200,947876,337324,24,0.0473734337681552,1
"24037",1,553200,393909,159291,41,0.0475270595311495,1
"24049",0,880800,645322,235478,29,0.0660517360877384,1
"24097",0,363600,288887,74713,22,0.245601262621583,1
"24100",0,1155600,810122,345478,38,0.020044122656236,1
"24103",0,948000,738645,209355,24,0.0863508609996796,1
"24117",0,366000,271248,94752,28,0.166433702010271,1
"24120",1,1369200,1035404,333796,47,0.00686706510068183,1
"24137",1,1371600,1016892,354708,50,0.00535129385879259,1
"24145",0,866400,618434,247966,37,0.0368160405093079,1
"24162",1,1059600,746798,312802,49,0.0101292702671625,1
"24184",0,387600,300484,87116,45,0.0475868819904724,1
"24208",0,411600,315860,95740,24,0.202033455023267,1
"24216",0,396000,311925,84075,27,0.170802120861828,1
"24218",0,951600,712499,239101,39,0.027413553564644,1
"24230",1,568800,432421,136379,26,0.138924665652087,1
"24236",0,361200,279004,82196,28,0.168307494284908,1
"24241",0,420000,295152,124848,21,0.238359512984745,1
"24245",1,1406400,1012519,393881,26,0.0324493604071704,1
"24270",0,610800,486812,123988,21,0.183075199762992,1
"24278",0,964800,701293,263507,39,0.0265494528650067,1
"24284",1,1366800,915221,451579,44,0.00833574231167211,1
"24286",0,1261200,954781,306419,23,0.0537953462402533,1
"24296",0,662400,516400,146000,21,0.168697451548056,1
"24301",1,964800,705231,259569,42,0.021070420460901,1
"24319",1,1021200,808376,212824,45,0.0154133105965748,1
"24333",0,501600,365486,136114,20,0.226226816837881,1
"24348",1,1190400,895135,295265,27,0.0449366275605642,1
"24351",0,422400,334709,87691,26,0.175344207248473,1
"24379",1,408000,286319,121681,35,0.0952106005429239,1
"24383",1,702000,570577,131423,28,0.0984533130443815,1
"24394",1,798000,590679,207321,28,0.082173761572387,1
"24396",0,633600,483295,150305,20,0.187443279216726,1
"24405",1,1078800,776425,302375,43,0.0157515261672371,1
"24406",0,942000,697212,244788,40,0.0257351378217578,1
"24409",0,1171200,856680,314520,33,0.0291061069411215,1
"24449",0,1015200,750583,264617,49,0.0111508524402536,1
"24451",1,525600,380056,145544,27,0.138038363603751,1
"24453",0,1113600,780017,333583,38,0.0216425761277316,1
"24466",1,500400,407322,93078,27,0.145980228525746,1
"24469",1,856800,639356,217444,40,0.0300733818116303,1
"24483",0,918000,679706,238294,26,0.0774892974842563,1
"24489",0,566400,422568,143832,20,0.206464104230133,1
"24495",0,369600,263507,106093,27,0.176167976054832,1
"24500",1,488400,396125,92275,38,0.0679245278914444,1
"24507",0,487200,360454,126746,21,0.217516720237962,1
"24520",0,639600,483706,155894,21,0.173803489414378,1
"24522",0,740400,531991,208409,47,0.0214128675062256,1
"24525",1,1260000,934421,325579,44,0.0105484510655987,1
"24540",0,1228800,896787,332013,27,0.0415450585567261,1
"24557",1,680400,533075,147325,47,0.024304422694542,1
"24570",0,1413600,1018097,395503,21,0.0469253942427373,1
"24571",1,1370400,997015,373385,42,0.0100022746630708,1
"24577",0,783600,588320,195280,29,0.0785251802670113,1
"24584",1,1185600,843128,342472,37,0.020603306595371,1
"24589",0,364800,266664,98136,22,0.243477315078145,1
"24665",0,477600,358972,118628,50,0.0275453964435505,1
"24666",0,366000,262145,103855,28,0.165927797856636,1
"24681",1,771600,559664,211936,35,0.0509375847668557,1
"24692",0,1334400,1009561,324839,25,0.0406288021571908,1
"24693",0,886800,678418,208382,30,0.0613371108109428,1
"24696",0,1122000,811942,310058,40,0.0184262262236767,1
"24708",0,417600,301140,116460,23,0.21198315572165,1
"24710",0,500400,397577,102823,21,0.215222224848606,1
"24720",0,1305600,1015789,289811,33,0.0233657500633703,1
"24726",1,1120800,785200,335600,48,0.00976561959428425,1
"24729",0,1110000,847116,262884,31,0.0384036170344924,1
"24735",0,1429200,1018876,410324,38,0.0121890391463758,1
"24741",1,1203600,817807,385793,37,0.0196391024902239,1
"24750",0,831600,636108,195492,57,0.00839935582766776,1
"24752",1,1224000,989686,234314,42,0.0136186317969359,1
"24755",1,744000,575999,168001,46,0.0233672593551563,1
"24771",0,940800,702891,237909,49,0.0128185863794329,1
"24772",0,904800,686977,217823,42,0.0237364646885621,1
"24774",0,1434000,1023959,410041,30,0.0225833257965239,1
"24780",0,740400,572405,167995,23,0.130192275649757,1
"24782",0,532800,385293,147507,20,0.216026241032906,1
"24799",0,586800,440242,146558,37,0.0610109053582775,1
"24801",0,1318800,1024805,293995,31,0.0266291318610706,1
"24803",0,459600,336666,122934,52,0.0242908538029025,1
"24806",0,577200,455057,122143,22,0.180127598476323,1
"24813",0,394800,292769,102031,27,0.170081128079055,1
"24831",0,500400,400886,99514,21,0.215446471538105,1
"24857",1,1033200,803795,229405,46,0.0138693198829184,1
"24858",0,464400,345311,119089,21,0.22492759330416,1
"24872",0,1028400,766906,261494,40,0.0220551383087167,1
"24881",0,457200,317266,139934,24,0.186752024050811,1
"24905",0,1009200,763789,245411,52,0.00896749290042814,1
"24936",0,628800,451992,176808,53,0.0164543974421346,1
"24964",0,703200,526273,176927,20,0.168074849259956,1
"24971",1,686400,548559,137841,27,0.108097129368628,1
"24998",1,446400,330373,116027,44,0.0460177843677135,1
"25014",0,453600,350271,103329,25,0.178036264739499,1
"25018",0,693600,508992,184608,20,0.170004748208271,1
"25032",1,1177200,885407,291793,30,0.0366030020454829,1
"25035",0,652800,475775,177025,21,0.169312114448968,1
"25036",0,372000,285600,86400,23,0.227749880765724,1
"25046",1,422400,263404,158996,47,0.0375022124328529,1
"25063",0,840000,608876,231124,46,0.0193353851852309,1
"25070",0,1089600,812732,276868,22,0.0776068560895578,1
"25080",0,1096800,882479,214321,33,0.0343325649948867,1
"25087",0,1064400,805657,258743,36,0.0283022065594248,1
"25088",0,1268400,966428,301972,24,0.04938102311568,1
"25100",0,454800,346643,108157,24,0.18934002178196,1
"25105",0,1048800,746806,301994,50,0.00958114119079489,1
"25113",0,538800,441257,97543,52,0.0214227344979661,1
"25161",0,414000,361011,52989,24,0.204127886011777,1
"25164",1,1015200,746126,269074,49,0.0111311584993509,1
"25167",0,388800,266907,121893,51,0.0296223887681443,1
"25168",0,400800,311149,89651,27,0.169299551056913,1
"25180",1,381600,286902,94698,47,0.0411757797795657,1
"25215",0,910800,740358,170442,53,0.0101296240681349,1
"25223",0,588000,431581,156419,22,0.175353144017175,1
"25233",1,834000,688552,145448,38,0.0374756297868049,1
"25241",0,452400,341855,110545,23,0.20235931979572,1
"25249",0,919200,701401,217799,34,0.0428443962604457,1
"25253",0,932400,764387,168013,30,0.0577702155304054,1
"25296",0,618000,466991,151009,21,0.179593681643464,1
"25301",1,958800,700835,257965,38,0.0290386543682564,1
"25310",1,397200,287652,109548,34,0.10448286669031,1
"25321",0,1209600,962510,247090,30,0.0352578106143064,1
"25334",0,746400,571296,175104,47,0.0214725720425393,1
"25337",0,1431600,1017739,413861,40,0.0103592179749536,1
"25341",0,517200,410214,106986,20,0.22349904222825,1
"25344",0,368400,281116,87284,54,0.0246537834496355,1
"25347",0,606000,491837,114163,51,0.0205001412370733,1
"25353",0,388800,300056,88744,26,0.183956708129435,1
"25361",0,718800,534975,183825,41,0.0356484540179725,1
"25363",1,1176000,893911,282089,32,0.0315773625188066,1
"25384",0,804000,652141,151859,36,0.0457825090169965,1
"25403",1,801600,591040,210560,30,0.0704585967533326,1
"25411",0,411600,323484,88116,26,0.178072278982889,1
"25412",0,453600,360399,93201,40,0.0619600713904638,1
"25431",0,1261200,915642,345558,28,0.0362571363159889,1
"25446",0,458400,381170,77230,21,0.229722904139357,1
"25452",1,1308000,1084829,223171,50,0.00630015559742853,1
"25456",1,987600,679443,308157,36,0.03163445177605,1
"25476",1,537600,410859,126741,49,0.0267807991713767,1
"25481",0,1152000,910755,241245,42,0.0153793156982915,1
"25489",0,1278000,988847,289153,46,0.00886282669887887,1
"25498",0,1408800,1096289,312511,43,0.00886096596755737,1
"25504",0,565200,395730,169470,29,0.112092228699576,1
"25513",0,675600,552051,123549,21,0.166726111375833,1
"25518",1,825600,665903,159697,34,0.0512178501948405,1
"25528",0,742800,572987,169813,38,0.0432787857790631,1
"25550",0,926400,679193,247207,43,0.0209223194708367,1
"25559",0,1094400,800584,293816,34,0.0309528639277008,1
"25567",1,456000,330549,125451,43,0.0486711511021255,1
"25570",0,433200,355777,77423,20,0.252304839230395,1
"25573",0,1404000,1031963,372037,24,0.0383007092836862,1
"25582",0,547200,416854,130346,22,0.187519306913755,1
"25588",0,514800,381170,133630,22,0.196114292258264,1
"25612",0,381600,264381,117219,44,0.0512437049491441,1
"25620",0,866400,597393,269007,24,0.096217121042342,1
"25623",0,774000,594924,179076,44,0.0258087933253792,1
"25630",0,968400,674088,294312,28,0.0602778219218277,1
"25638",1,884400,660455,223945,41,0.0264939145874566,1
"25659",0,1424400,957954,466446,25,0.0330448781664185,1
"25663",0,364800,299357,65443,20,0.276536189661336,1
"25668",1,1012800,775134,237666,35,0.03364068558009,1
"25672",0,716400,550398,166002,50,0.0179616767067368,1
"25677",0,674400,504777,169623,48,0.0225245646207549,1
"25686",0,368400,256765,111635,28,0.164916467229411,1
"25695",0,489600,377243,112357,21,0.217783394725084,1
"25697",0,549600,428788,120812,21,0.199863487961808,1
"25705",1,1146000,844890,301110,42,0.0151762484945768,1
"25713",0,523200,433401,89799,24,0.172675231945215,1
"25719",0,1150800,863562,287238,22,0.0699990847183738,1
"25722",0,508800,396684,112116,24,0.175013276847378,1
"25729",0,541200,416026,125174,24,0.166240319502539,1
"25737",1,814800,609391,205409,50,0.0149261515369716,1
"25749",0,505200,338823,166377,23,0.184445049225452,1
"25752",1,940800,710916,229884,50,0.0118889854424739,1
"25753",0,386400,309465,76935,32,0.123739187286748,1
"25754",0,499200,366013,133187,25,0.164987060876174,1
"25757",0,472800,369381,103419,22,0.209978617246252,1
"25758",1,728400,516840,211560,44,0.0275443958001867,1
"25760",0,1082400,796724,285676,46,0.0124576790370662,1
"25778",0,580800,431312,149488,22,0.17759046660573,1
"25785",0,417600,306490,111110,22,0.225932434757718,1
"25788",0,418800,312192,106608,23,0.212292176249503,1
"25790",0,878400,637297,241103,36,0.0390477426723019,1
"25792",0,451200,345833,105367,23,0.203034741901283,1
"25803",1,1251600,820783,430817,27,0.0384894945675863,1
"25804",1,405600,335836,69764,29,0.148057186701418,1
"25811",0,662400,503969,158431,52,0.0169127947945164,1
"25819",1,901200,785769,115431,44,0.0212851115848548,1
"25824",0,681600,491054,190546,20,0.172651621932979,1
"25835",0,685200,499891,185309,20,0.172051494690331,1
"25837",1,999600,690627,308973,45,0.0154024160826055,1
"25839",1,363600,290051,73549,35,0.103910258040148,1
"25841",1,1280400,1023973,256427,34,0.0228711532540093,1
"25844",0,367200,284941,82259,37,0.0892195807378898,1
"25851",0,609600,461201,148399,20,0.194051758273276,1
"25855",0,1348800,1091123,257677,38,0.0148782945255275,1
"25863",0,1075200,754134,321066,52,0.00775891622924983,1
"25869",1,1328400,1020003,308397,38,0.0151057060165319,1
"25870",0,369600,287565,82035,23,0.228799075868436,1
"25884",0,836400,587272,249128,55,0.00954449443321179,1
"25886",0,493200,377249,115951,20,0.230243628081193,1
"25903",0,1080000,765482,314518,31,0.0395973824278841,1
"25905",1,1402800,997405,405395,28,0.0278606214943935,1
"25910",0,541200,408628,132572,23,0.177112517494387,1
"25934",0,362400,278440,83960,22,0.245303772245701,1
"25939",0,1113600,789259,324341,32,0.0345280970521183,1
"25943",1,424800,328673,96127,43,0.0518407200888621,1
"25945",0,687600,454981,232619,20,0.168774545680388,1
"25953",0,452400,313652,138748,25,0.176271965725642,1
"25955",1,927600,701394,226206,49,0.0131754618573965,1
"25958",0,526800,405199,121601,47,0.0318900214086928,1
"25962",1,852000,659779,192221,42,0.0262384430999728,1
"25966",0,529200,422300,106900,24,0.17020766326009,1
"25980",0,450000,343126,106874,22,0.216447135602654,1
"25981",0,360000,253618,106382,27,0.178605437264343,1
"25989",1,1042800,792212,250588,31,0.0431993159299398,1
"26004",1,625200,439765,185435,45,0.0307040856411834,1
"26010",0,1016400,702072,314328,56,0.00628570108916164,1
"26018",0,1134000,891045,242955,23,0.0679286926379507,1
"26028",0,1137600,859817,277783,56,0.00516398557071684,1
"26047",0,747600,556585,191015,48,0.0197007684422388,1
"26053",1,1198800,859479,339321,47,0.00921389439214937,1
"26072",0,486000,354781,131219,25,0.16830847673477,1
"26074",0,979200,682996,296204,34,0.0375805503030924,1
"26077",0,1426800,1046688,380112,41,0.00978605273001583,1
"26093",1,508800,394084,114716,26,0.153107217185792,1
"26097",0,1358400,1174123,184277,26,0.0381652128406206,1
"26098",0,392400,288159,104241,26,0.182084218402792,1
"26150",0,402000,301005,100995,43,0.0537404372420919,1
"26151",0,795600,628204,167396,25,0.103900031538253,1
"26163",0,577200,448071,129129,22,0.179714173121879,1
"26175",0,1309200,999943,309257,26,0.039511812055101,1
"26183",0,529200,406857,122343,23,0.180804500970625,1
"26185",0,1328400,1014951,313449,39,0.0139403172229212,1
"26186",0,1236000,1031801,204199,49,0.00778565080555427,1
"26192",0,651600,527773,123827,21,0.172634330047668,1
"26195",0,589200,462723,126477,23,0.165523637917565,1
"26197",0,1438800,1101300,337500,24,0.0366023318929457,1
"26206",1,1390800,1040729,350071,36,0.0156021724442936,1
"26211",0,465600,369076,96524,25,0.175374617347976,1
"26228",0,553200,413305,139895,40,0.0516350142024742,1
"26239",0,417600,323544,94056,26,0.176192761059519,1
"26243",0,390000,307741,82259,30,0.140995853640301,1
"26245",1,1356000,1066212,289788,25,0.0397116920714858,1
"26252",0,1422000,1048248,373752,50,0.00486411170559816,1
"26265",1,399600,306911,92689,30,0.138471133522715,1
"26272",0,463200,351067,112133,24,0.18684891608497,1
"26281",0,1159200,871816,287384,41,0.0161284610265754,1
"26283",1,897600,550665,346935,45,0.0180885787227244,1
"26284",0,370800,278505,92295,56,0.0209803716654939,1
"26303",0,470400,324586,145814,22,0.207863341748695,1
"26316",1,1185600,946377,239223,47,0.00980984012771508,1
"26319",1,499200,364427,134773,40,0.0565791590354195,1
"26323",0,770400,607083,163317,47,0.0207022113387086,1
"26326",0,489600,369700,119900,52,0.0231031809208029,1
"26331",0,414000,329796,84204,23,0.215215746576653,1
"26336",0,364800,271602,93198,25,0.202610265145465,1
"26355",1,1214400,1009298,205102,25,0.0519795923281219,1
"26363",1,730800,515158,215642,32,0.068081287779807,1
"26399",1,542400,420221,122179,32,0.095439070252823,1
"26400",0,800400,622942,177458,41,0.0311236898323651,1
"26411",1,1434000,1066669,367331,47,0.00605309582649886,1
"26423",0,476400,336237,140163,21,0.219830319554975,1
"26430",1,904800,690884,213916,48,0.0148936409282015,1
"26436",1,630000,473332,156668,25,0.134682953422031,1
"26451",0,366000,274302,91698,27,0.177928206160509,1
"26458",0,417600,315508,102092,20,0.255608747034872,1
"26461",0,572400,433312,139088,23,0.168918267480964,1
"26463",0,372000,277388,94612,24,0.21352653995895,1
"26468",0,1023600,766747,256853,27,0.0601506064913403,1
"26471",1,918000,726561,191439,46,0.0171739153366142,1
"26472",1,1273200,905435,367765,34,0.0221659540059436,1
"26480",1,513600,375859,137741,49,0.0277794626923585,1
"26482",1,732000,514113,217887,47,0.0216428082455601,1
"26484",0,369600,292408,77192,27,0.177856620716234,1
"26502",1,892800,644866,247934,44,0.0204991587467669,1
"26503",1,541200,397164,144036,42,0.045214774894186,1
"26509",0,451200,361819,89381,24,0.191473194814355,1
"26526",0,666000,489888,176112,41,0.039085053149249,1
"26527",1,1286400,933387,353013,49,0.00672183943805617,1
"26529",0,1299600,1036760,262840,33,0.0238574797863916,1
"26551",1,1026000,733163,292837,27,0.0591055782659973,1
"26555",0,457200,346627,110573,25,0.176692039851241,1
"26561",0,394800,273882,120918,22,0.232292915891192,1
"26581",0,709200,520231,188969,20,0.165940498449111,1
"26583",1,439200,318074,121126,31,0.12043905403433,1
"26591",0,456000,355617,100383,21,0.228825023616781,1
"26594",0,1196400,860323,336077,41,0.0148379546829827,1
"26598",1,693600,558366,135234,44,0.0301066675997996,1
"26601",1,504000,406739,97261,28,0.135414222537371,1
"26606",0,523200,360405,162795,59,0.0124121273384981,1
"26608",0,1083600,820450,263150,53,0.0072314656780194,1
"26615",1,819600,643919,175681,27,0.0863622504773236,1
"26617",1,1012800,773267,239533,50,0.0104545975918699,1
"26619",0,530400,389846,140554,21,0.204008700561746,1
"26633",0,364800,266974,97826,24,0.215434725998054,1
"26644",0,1114800,779217,335583,34,0.0294164781515539,1
"26664",0,868800,697325,171475,28,0.0742722008837163,1
"26675",1,1261200,827060,434140,36,0.0188675050437342,1
"26698",0,465600,313024,152576,43,0.047404519492599,1
"26702",0,572400,364082,208318,20,0.200567882660355,1
"26705",0,633600,448159,185441,20,0.185306344002534,1
"26711",1,1248000,907837,340163,32,0.0273137441087428,1
"26723",1,1384800,1124018,260782,31,0.0241016811865352,1
"26732",0,556800,392765,164035,21,0.195116805502664,1
"26737",0,1280400,982770,297630,44,0.0102954461977314,1
"26738",0,1178400,954670,223730,30,0.0375019500715825,1
"26740",1,406800,327944,78856,34,0.104061617502603,1
"26753",0,742800,564749,178051,22,0.138470214863316,1
"26760",0,453600,327169,126431,25,0.176684362491704,1
"26765",1,448800,350205,98595,37,0.0777925445305452,1
"26774",0,606000,478529,127471,20,0.19636133457475,1
"26778",0,660000,538199,121801,20,0.182197076274012,1
"26779",0,523200,396337,126863,21,0.206964728946466,1
"26814",0,374400,307591,66809,27,0.17723665418433,1
"26820",0,1396800,982450,414350,27,0.0302976124383825,1
"26840",0,1398000,906053,491947,26,0.0316853779867592,1
"26842",0,1040400,797534,242866,23,0.079079599532994,1
"26847",1,1101600,863954,237646,50,0.00896845157118376,1
"26849",1,459600,355037,104563,46,0.0388271614766417,1
"26853",1,458400,343020,115380,41,0.0565695559695154,1
"26866",0,402000,287558,114442,30,0.136935854260613,1
"26890",0,463200,354045,109155,29,0.133930906328116,1
"26892",0,550800,388255,162545,57,0.0138440123224982,1
"26898",1,508800,368003,140797,37,0.0694753263512505,1
"26900",0,480000,378016,101984,23,0.195204957650646,1
"26902",0,484800,343324,141476,20,0.231038594146159,1
"26906",1,913200,707357,205843,31,0.0545392314344369,1
"26908",1,504000,388771,115229,28,0.134572707262774,1
"26916",0,1224000,880337,343663,31,0.0306919734996906,1
"26921",0,403200,293972,109228,25,0.190962343125299,1
"26929",1,531600,416655,114945,49,0.0271809846549305,1
"26931",0,608400,444053,164347,20,0.19338109134262,1
"26936",1,506400,346587,159813,48,0.0301171793547919,1
"26948",1,1008000,822810,185190,27,0.0633999807852099,1
"26949",1,1134000,876765,257235,38,0.0215344055861409,1
"26961",0,884400,626275,258125,44,0.0207136938275957,1
"26969",0,790800,598335,192465,32,0.0622471734490669,1
"26989",0,1221600,922443,299157,28,0.039460510458671,1
"26991",1,366000,298148,67852,42,0.06223750535676,1
"27006",0,446400,324487,121913,23,0.203321914371084,1
"27023",0,996000,792710,203290,21,0.0995383178872989,1
"27040",0,410400,316079,94321,24,0.202464510701087,1
"27049",1,598800,437047,161753,44,0.0349933574007247,1
"27054",0,1246800,931477,315323,41,0.0137130488153232,1
"27080",1,728400,513590,214810,39,0.0403835811327452,1
"27091",0,570000,435432,134568,21,0.193346880245291,1
"27092",0,505200,375984,129216,22,0.199061718006912,1
"27109",0,487200,374517,112683,23,0.192562661653467,1
"27113",1,1405200,1060559,344641,25,0.0357847884231823,1
"27118",1,884400,631643,252757,33,0.0483378428216313,1
"27120",0,386400,288807,97593,20,0.266500872358598,1
"27142",1,982800,743215,239585,45,0.0162953932785383,1
"27148",0,604800,453983,150817,21,0.183038113359866,1
"27153",1,1432800,1114490,318310,46,0.00669347343974021,1
"27167",1,848400,678688,169712,26,0.0888703863427549,1
"27173",1,518400,395294,123106,30,0.114214590771821,1
"27181",0,742800,560160,182640,44,0.0271816223666777,1
"27189",0,446400,314389,132011,22,0.215807690766657,1
"27190",0,550800,409996,140804,21,0.198249885880462,1
"27193",1,1288800,936568,352232,32,0.0253574597326826,1
"27194",1,752400,553292,199108,25,0.109910935195008,1
"27201",0,414000,344051,69949,25,0.190473282337346,1
"27218",1,740400,573604,166796,30,0.0790820681809113,1
"27220",0,654000,496312,157688,40,0.0433435104102275,1
"27224",0,1352400,970053,382347,33,0.0207965254893036,1
"27226",1,871200,676948,194252,26,0.0849204123834728,1
"27227",0,619200,450165,169035,21,0.178222758142254,1
"27232",0,670800,511326,159474,52,0.0166629645342937,1
"27233",0,462000,333118,128882,20,0.239129676856093,1
"27256",0,1273200,878040,395160,21,0.0592449654946994,1
"27274",0,919200,762509,156691,32,0.0510284983885954,1
"27298",0,406800,306889,99911,33,0.110869568596548,1
"27301",0,1008000,749283,258717,44,0.0167440602989826,1
"27303",0,1432800,1056191,376609,47,0.00604336474330358,1
"27310",0,424800,310365,114435,26,0.173195584426934,1
"27313",0,518400,379702,138698,24,0.171080744018808,1
"27315",1,926400,658836,267564,49,0.0129884471505246,1
"27321",0,1257600,905178,352422,48,0.00764895621035335,1
"27328",0,1237200,875535,361665,25,0.0471435513228981,1
"27331",0,931200,758967,172233,22,0.103788962312089,1
"27364",0,468000,377875,90125,22,0.212267336132936,1
"27366",1,564000,444866,119134,28,0.122624214561934,1
"27368",1,711600,504866,206734,35,0.0563772276091234,1
"27369",0,930000,719219,210781,27,0.0713328717237289,1
"27376",1,522000,390600,131400,28,0.130205570377516,1
"27388",0,1033200,780278,252922,23,0.0797068431810686,1
"27389",0,522000,386186,135814,21,0.206720683051482,1
"27396",1,444000,363655,80345,43,0.0505146356173705,1
"27404",0,381600,327679,53921,23,0.2270833766989,1
"27416",1,790800,615423,175377,34,0.0539413606183491,1
"27429",0,466800,340887,125913,37,0.0747981280652485,1
"27442",1,1281600,942289,339311,35,0.0204415673513188,1
"27453",0,511200,406668,104532,27,0.143072748800289,1
"27457",1,514800,403525,111275,36,0.0748821826086534,1
"27475",0,570000,441672,128328,21,0.193737517032472,1
"27480",1,715200,512173,203027,45,0.0261624607431824,1
"27483",0,991200,769142,222058,27,0.0642753817092958,1
"27504",1,876000,628145,247855,29,0.0662646281789612,1
"27505",1,529200,412080,117120,38,0.0629458019942166,1
"27520",0,392400,309946,82454,23,0.221797732278543,1
"27527",1,1436400,1125729,310671,50,0.00486445212959883,1
"27528",0,861600,565598,296002,43,0.0229363412851617,1
"27536",1,1126800,816472,310328,49,0.00902318431677107,1
"27548",0,1150800,933473,217327,25,0.0574867997434713,1
"27552",0,391200,263030,128170,25,0.193045512812858,1
"27554",1,1279200,991083,288117,37,0.0179213104847273,1
"27559",0,456000,332554,123446,26,0.16500826259551,1
"27562",0,566400,387489,178911,21,0.191563095139127,1
"27568",0,400800,304422,96378,30,0.138044352880644,1
"27569",0,1272000,1006921,265079,31,0.029165669733334,1
"27578",0,373200,277425,95775,20,0.271190268847899,1
"27594",0,487200,377504,109696,29,0.129103582296053,1
"27610",0,594000,395594,198406,22,0.171432871654064,1
"27616",0,549600,424405,125195,33,0.0876853504916689,1
"27632",0,506400,370208,136192,37,0.0698676007534433,1
"27638",0,378000,251729,126271,20,0.267129893857408,1
"27643",1,657600,460463,197137,48,0.0229332588671087,1
"27645",1,823200,572425,250775,37,0.0395533987953624,1
"27658",0,730800,545654,185146,36,0.0510724789971874,1
"27661",1,829200,685746,143454,40,0.0324349502317983,1
"27684",0,409200,289117,120083,21,0.242162363831845,1
"27689",0,650400,466757,183643,20,0.181010546812961,1
"27698",0,582000,433072,148928,20,0.201692620447347,1
"27700",0,782400,620575,161825,57,0.00927183385351884,1
"27707",1,1039200,804713,234487,35,0.0322086993782175,1
"27709",0,465600,334177,131423,21,0.223701010991136,1
"27712",0,402000,265873,136127,20,0.25822074866743,1
"27714",1,1262400,1006887,255513,37,0.0186850664548245,1
"27724",0,501600,359161,142439,59,0.0129889562772834,1
"27727",0,668400,506949,161451,31,0.0827137605315046,1
"27740",0,933600,700359,233241,43,0.0207791300943368,1
"27741",0,386400,282592,103808,21,0.250793396871682,1
"27744",0,662400,527319,135081,20,0.180781187316184,1
"27756",0,420000,300182,119818,55,0.0206178872327106,1
"27776",0,818400,646622,171778,23,0.115327586599415,1
"27785",0,723600,530691,192909,32,0.0694731668818137,1
"27796",0,484800,378730,106070,22,0.206337888617839,1
"27803",0,700800,510674,190126,22,0.146876868523044,1
"27810",0,648000,488960,159040,31,0.0855420220920134,1
"27818",1,1309200,971057,338143,26,0.03907446914991,1
"27821",1,667200,485654,181546,38,0.0488881481729603,1
"27822",0,1150800,848436,302364,21,0.0749292111733231,1
"27824",0,531600,405373,126227,21,0.204601045743192,1
"27827",0,805200,607131,198069,51,0.0140735942155287,1
"27828",0,543600,397982,145618,22,0.187547076354328,1
"27831",0,471600,366201,105399,24,0.185030000317007,1
"27836",0,579600,485552,94048,46,0.0318278355388014,1
"27842",1,525600,428025,97575,35,0.0795857131550826,1
"27857",0,1057200,836084,221116,49,0.0105485050808811,1
"27868",0,549600,415366,134234,23,0.174881490448702,1
"27876",0,652800,516564,136236,20,0.183216293963396,1
"27877",0,399600,311186,88414,27,0.169665332761609,1
"27882",1,771600,612466,159134,27,0.0937956732003378,1
"27901",0,442800,354616,88184,22,0.219877413535853,1
"27907",1,627600,462707,164893,48,0.0244476110843275,1
"27909",0,469200,397035,72165,20,0.240978206147284,1
"27911",0,1160400,880056,280344,22,0.0690896202985693,1
"27917",0,986400,784470,201930,21,0.101105666134794,1
"27921",0,836400,610467,225933,24,0.102463905260578,1
"27938",0,578400,415578,162822,20,0.201810981927272,1
"27944",0,504000,374673,129327,23,0.187010310534656,1
"27963",0,393600,283773,109827,27,0.169936592837962,1
"27966",0,642000,459076,182924,37,0.0549376096576645,1
"27976",1,576000,403756,172244,37,0.0615066354047292,1
"27986",0,1135200,855292,279908,34,0.0290359386993764,1
"27992",0,1423200,1098671,324529,34,0.0174252493776163,1
"28011",0,476400,331940,144460,23,0.193524983722945,1
"28054",0,919200,698948,220252,36,0.0367468990661111,1
"28060",1,405600,282084,123516,48,0.0362319282987629,1
"28068",1,786000,582675,203325,33,0.0579890536478185,1
"28070",0,1258800,1006851,251949,36,0.0203525187607342,1
"28071",0,366000,258956,107044,25,0.201376202458277,1
"28091",1,583200,407308,175892,43,0.0385728117098725,1
"28093",1,464400,362160,102240,32,0.108679509295516,1
"28111",0,546000,382663,163337,20,0.211075877916755,1
"28113",0,621600,497097,124503,20,0.192268700993378,1
"28123",0,378000,305253,72747,26,0.187790975950586,1
"28125",1,924000,662488,261512,30,0.0565424965000155,1
"28127",1,873600,667912,205688,39,0.031711323985468,1
"28140",1,1437600,1118188,319412,37,0.0134695163269572,1
"28144",0,594000,411801,182199,22,0.172358172170384,1
"28147",0,1131600,911649,219951,56,0.00534007410237317,1
"28151",1,637200,441501,195699,35,0.0639912118882165,1
"28170",0,1316400,934045,382355,43,0.0101175148192153,1
"28190",1,726000,622993,103007,42,0.03365385712035,1
"28192",1,1178400,878908,299492,35,0.0247771477121142,1
"28195",0,566400,418569,147831,21,0.193501023444403,1
"28199",1,997200,662660,334540,27,0.0610097482529148,1
"28201",1,1382400,1106246,276154,30,0.0259929429229773,1
"28203",0,906000,684145,221855,42,0.0236504210388391,1
"28208",1,1137600,894542,243058,29,0.0430264025569116,1
"28213",0,432000,346073,85927,32,0.114965965357882,1
"28230",1,1322400,942749,379651,32,0.0236867987567063,1
"28232",1,1189200,859797,329403,43,0.0128787627034978,1
"28244",0,484800,385802,98998,21,0.220137955339202,1
"28278",0,522000,365509,156491,22,0.192702655809743,1
"28295",1,752400,583149,169251,48,0.0197069308622409,1
"28297",1,693600,480877,212723,48,0.0214301461527746,1
"28302",1,619200,458249,160951,33,0.0773779943317623,1
"28308",0,1086000,742823,343177,29,0.045143734165006,1
"28311",0,631200,426699,204501,45,0.0301682133849119,1
"28322",0,387600,263168,124432,26,0.182130668324108,1
"28323",0,1050000,747530,302470,49,0.0103416436678785,1
"28325",0,426000,340897,85103,24,0.198674838191467,1
"28329",0,368400,264097,104303,28,0.165321859624585,1
"28355",0,492000,419315,72685,24,0.181643037339668,1
"28357",0,399600,323662,75938,27,0.170371439827655,1
"28363",0,615600,506839,108761,21,0.182731043838281,1
"28371",0,595200,465207,129993,20,0.199203155762149,1
"28372",1,1134000,787892,346108,38,0.0207960084749919,1
"28380",0,513600,385628,127972,46,0.0351266609580314,1
"28382",0,543600,403684,139916,21,0.200319701016856,1
"28385",0,591600,453172,138428,20,0.19967007695631,1
"28392",1,1094400,704312,390088,40,0.0187226205885572,1
"28397",1,1035600,779562,256038,35,0.032135958800001,1
"28402",0,487200,331534,155666,20,0.229285089696497,1
"28403",0,448800,310974,137826,21,0.228401337746546,1
"28435",0,1387200,1056468,330732,28,0.029454650722454,1
"28443",0,696000,570875,125125,57,0.0109288733034302,1
"28449",1,848400,654508,193892,41,0.0285021429375656,1
"28456",0,582000,430197,151803,37,0.0613731922223603,1
"28458",0,417600,299651,117949,23,0.211883411396493,1
"28463",0,699600,551498,148102,20,0.170588191950983,1
"28468",0,524400,350129,174271,22,0.190945235941879,1
"28477",0,420000,347362,72638,27,0.165561497139267,1
"28490",1,1303200,987836,315364,47,0.00775912372149486,1
"28491",1,915600,657657,257943,38,0.0312508441758295,1
"28492",1,648000,458251,189749,43,0.0343909719902677,1
"28511",0,403200,300583,102617,25,0.191372330746761,1
"28548",0,926400,648320,278080,21,0.108088587786029,1
"28564",0,594000,376233,217767,43,0.0372698282891605,1
"28571",0,768000,606196,161804,39,0.0385593660539414,1
"28579",0,548400,453861,94539,37,0.0662602954938769,1
"28581",0,402000,290836,111164,20,0.260143144852283,1
"28582",0,429600,326641,102959,31,0.123016203356792,1
"28592",0,410400,305819,104581,20,0.25782538176661,1
"28620",0,988800,716506,272294,42,0.0201194505146213,1
"28655",0,656400,524162,132238,20,0.182513392699188,1
"28659",0,477600,368105,109495,22,0.208184888645661,1
"28663",0,1393200,1114863,278337,34,0.0186851091710042,1
"28675",1,625200,468906,156294,42,0.0390846977760443,1
"28707",1,1291200,949346,341854,28,0.0345140302970288,1
"28713",1,1221600,967457,254143,37,0.0200527249867406,1
"28741",1,469200,356661,112539,40,0.0599517473370898,1
"28745",0,376800,274768,102032,27,0.174579168475796,1
"28754",1,1114800,865335,249465,39,0.0206530954168491,1
"28755",0,1198800,896739,302061,20,0.0746154384695962,1
"28763",0,1044000,797283,246717,53,0.00779782733763827,1
"28768",0,522000,380650,141350,20,0.219671189926227,1
"28791",0,1074000,855564,218436,24,0.0702121875769036,1
"28793",1,1185600,914605,270995,50,0.00764836778983802,1
"28797",0,936000,726541,209459,36,0.0358684815059197,1
"28801",0,444000,357704,86296,23,0.206333449097918,1
"28805",1,924000,714744,209256,30,0.0576710032382155,1
"28821",1,458400,357775,100625,50,0.02866131156315,1
"28822",1,775200,605161,170039,50,0.0162060398633683,1
"28828",0,673200,449026,224174,20,0.172827403916002,1
"28857",0,550800,433069,117731,36,0.0704583377529024,1
"28876",0,454800,334561,120239,21,0.22779235301252,1
"28890",1,1308000,992331,315669,39,0.0144276034655836,1
"28898",0,498000,394564,103436,27,0.145986542788461,1
"28909",0,679200,546197,133003,21,0.165327739691999,1
"28917",0,543600,413812,129788,20,0.214031824443336,1
"28922",1,1326000,1021492,304508,26,0.0384801551960277,1
"28933",1,748800,597110,151690,40,0.0370411697918343,1
"28938",0,770400,597778,172622,38,0.0412755251465184,1
"28941",1,1160400,917069,243331,31,0.035540100517028,1
"28948",1,1245600,1021498,224102,42,0.0131726326787021,1
"28955",1,910800,648842,261958,46,0.0169114353478167,1
"28964",1,966000,694808,271192,46,0.0153204368185863,1
"28965",0,1278000,940353,337647,38,0.0162882714298406,1
"28966",1,982800,775140,207660,28,0.060819578831218,1
"28972",0,549600,404961,144639,22,0.186009943386335,1
"28986",1,1026000,725718,300282,26,0.0635036658694975,1
"29007",0,621600,477943,143657,26,0.127897248273661,1
"29029",0,542400,375265,167135,42,0.0447265828314932,1
"29039",0,429600,320052,109548,20,0.251066101438762,1
"29044",0,652800,495817,156983,21,0.170445693894742,1
"29067",0,835200,613895,221305,39,0.0336393855191436,1
"29068",1,1405200,1104089,301111,37,0.0143485065300577,1
"29081",0,474000,342690,131310,23,0.195008737654539,1
"29084",0,643200,481312,161888,20,0.184195763786644,1
"29087",0,1400400,962686,437714,30,0.0236622001875682,1
"29089",0,1046400,774573,271827,31,0.0425906401789607,1
"29100",0,696000,554315,141685,51,0.0173725662007924,1
"29103",0,6e+05,478142,121858,56,0.0139751262143777,1
"29112",0,783600,571940,211660,40,0.0341249236446783,1
"29116",0,412800,332146,80654,27,0.16686420828323,1
"29124",0,388800,294790,94010,23,0.222086575506356,1
"29133",1,973200,746808,226392,48,0.0131686167930313,1
"29154",0,556800,435890,120910,23,0.173834762275984,1
"29190",0,427200,325678,101522,20,0.252464648831608,1
"29193",1,1099200,924001,175199,45,0.0136730177833979,1
"29195",0,999600,787324,212276,33,0.0404809381105629,1
"29213",0,436800,328622,108178,22,0.220305407149484,1
"29232",1,1081200,718474,362726,27,0.0525378772829501,1
"29236",0,672000,480694,191306,54,0.0140425600786538,1
"29241",0,427200,332905,94295,25,0.185453060797133,1
"29263",0,661200,514058,147142,21,0.168928197479065,1
"29268",0,403200,308033,95167,25,0.191835154600807,1
"29272",0,1320000,1014658,305342,47,0.00756587883270527,1
"29279",0,382800,278812,103988,22,0.237290220253554,1
"29288",1,1159200,821733,337467,44,0.0125014762703077,1
"29292",0,447600,319200,128400,25,0.178103167391872,1
"29314",0,588000,483493,104507,48,0.0267822468947133,1
"29328",0,972000,745953,226047,35,0.0362059649409031,1
"29337",1,678000,539991,138009,38,0.0488202670118897,1
"29339",0,892800,666706,226094,40,0.0281918669805418,1
"29350",0,409200,294089,115111,20,0.257419761116453,1
"29365",1,673200,532126,141074,33,0.0714147176081383,1
"29370",1,1426800,1085716,341084,45,0.00725283002604615,1
"29383",1,1281600,904455,377145,35,0.0201399190103564,1
"29398",0,555600,435972,119628,21,0.198263111091144,1
"29403",0,374400,305154,69246,24,0.21453060643654,1
"29407",0,1440000,1008214,431786,21,0.0442795713446242,1
"29409",0,544800,421519,123281,22,0.188594048525212,1
"29425",0,556800,426388,130412,20,0.210125423290599,1
"29429",0,883200,631227,251973,38,0.0330924773086664,1
"29434",0,1206000,845683,360317,33,0.0269458487711149,1
"29454",0,516000,403650,112350,55,0.0175332216118951,1
"29458",0,592800,440975,151825,20,0.198478112750197,1
"29462",0,372000,290737,81263,20,0.272759053946933,1
"29474",0,618000,450635,167365,21,0.178629153132186,1
"29475",1,1263600,909726,353874,48,0.0075651988623823,1
"29476",1,1240800,924769,316031,32,0.0279123270915714,1
"29498",0,436800,327457,109343,20,0.248716878311016,1
"29503",0,1052400,702872,349528,55,0.00629977138358431,1
"29523",1,1034400,845044,189356,29,0.0521730205011227,1
"29551",0,553200,399597,153603,28,0.123173733221601,1
"29556",1,738000,517798,220202,31,0.0723228580010461,1
"29569",1,939600,658909,280691,26,0.0736581130196247,1
"29571",0,393600,285416,108184,23,0.219661009057568,1
"29576",1,709200,512320,196880,32,0.0710168919742636,1
"29603",1,1060800,772309,288491,47,0.0119428291105237,1
"29617",1,427200,355724,71476,43,0.0521207208729599,1
"29639",0,360000,271071,88929,26,0.191641266416283,1
"29652",1,478800,351557,127243,34,0.0912516929716763,1
"29664",0,562800,435048,127752,45,0.0349012513103913,1
"29672",1,1147200,931682,215518,40,0.0183137980332114,1
"29675",1,724800,562533,162267,40,0.0384136122222448,1
"29687",1,1375200,1193000,182200,29,0.0294876795276154,1
"29688",0,637200,463297,173903,24,0.141819847141923,1
"29690",0,661200,486955,174245,40,0.0425520555912341,1
"29692",0,387600,298013,89587,23,0.222757016524106,1
"29697",0,1424400,1081270,343130,20,0.0507092210000251,1
"29717",0,396000,309725,86275,27,0.170677187245065,1
"29735",0,448800,369156,79644,26,0.169209080410152,1
"29738",0,673200,537076,136124,21,0.16660964567935,1
"29742",0,1353600,920509,433091,24,0.0407218925093316,1
"29750",0,1172400,896599,275801,31,0.0343913062436648,1
"29752",1,649200,511586,137614,34,0.0690635550547592,1
"29756",1,594000,412673,181327,42,0.0407955981605288,1
"29760",0,675600,571254,104346,20,0.179187151715226,1
"29778",1,645600,459939,185661,35,0.0633538025637266,1
"29800",0,516000,361784,154216,21,0.20723474844046,1
"29812",1,655200,493795,161405,34,0.0677852532696216,1
"29817",0,404400,349051,55349,22,0.233987493794748,1
"29830",0,481200,377040,104160,25,0.171022167242684,1
"29839",0,493200,361490,131710,33,0.0956929121718232,1
"29849",1,883200,668925,214275,37,0.0362555655379673,1
"29852",0,1064400,765251,299149,46,0.012783323089317,1
"29861",0,668400,509183,159217,31,0.0827817684601419,1
"29862",0,609600,453963,155637,21,0.181496496996672,1
"29864",0,985200,691342,293858,28,0.0586419528961814,1
"29867",0,573600,447848,125752,22,0.180846455729041,1
"29871",1,555600,388340,167260,28,0.122131804173568,1
"29874",0,387600,320230,67370,24,0.210784296448559,1
"29877",0,619200,491278,127922,22,0.169188532023441,1
"29891",1,1213200,856953,356247,44,0.0113012775433104,1
"29892",0,520800,416046,104754,23,0.184051716808249,1
"29905",0,379200,297264,81936,20,0.270210654872504,1
"29907",0,714000,528700,185300,57,0.0103431805496831,1
"29915",0,879600,659408,220192,39,0.0312137201879913,1
"29916",0,741600,572420,169180,42,0.0319451663879721,1
"29917",0,997200,761043,236157,51,0.00994234060113327,1
"29920",0,448800,364999,83801,24,0.192472636803807,1
"29935",0,411600,298790,112810,27,0.165368925955302,1
"29936",0,469200,370624,98576,20,0.239045996814754,1
"29938",0,510000,364628,145372,40,0.0553548290412091,1
"29941",0,367200,292443,74757,22,0.244431207596303,1
"29942",0,489600,372608,116992,23,0.191641822293775,1
"29944",1,540000,416975,123025,45,0.036338441161194,1
"29955",0,612000,423145,188855,21,0.17890711979617,1
"29973",0,466800,340216,126584,24,0.18501690982477,1
"29978",1,416400,309737,106663,28,0.153917615856246,1
"29982",0,390000,296474,93526,22,0.235769889649186,1
"29985",0,488400,371610,116790,40,0.0579904830217567,1
"29988",1,654000,492177,161823,42,0.0371535989404022,1
"29992",0,918000,587899,330101,28,0.0646055177321533,1
"29995",1,1428000,1057895,370105,41,0.00980458912116548,1
"29997",1,998400,767787,230613,42,0.0201174255520814,1
"30003",1,1015200,720384,294816,25,0.0697530264827822,1
"30004",0,678000,490403,187597,52,0.0162759309278402,1
"30010",0,368400,281047,87353,27,0.177568325447104,1
"30016",1,441600,316556,125044,35,0.0901479108167326,1
"30029",0,642000,480298,161702,21,0.172867159941403,1
"30032",0,1262400,806010,456390,42,0.0116704622641598,1
"30034",0,538800,368420,170380,21,0.199710317159969,1
"30058",0,1326000,1000613,325387,27,0.0353594316418989,1
"30080",1,789600,592051,197549,33,0.0577714288005454,1
"30083",0,954000,642677,311323,22,0.0952158143538973,1
"30085",1,1141200,920899,220301,34,0.0294159624083774,1
"30099",0,1072800,820466,252334,38,0.0239594906980231,1
"30100",1,829200,607630,221570,48,0.0169161358025924,1
"30106",0,585600,492917,92683,23,0.168285297015039,1
"30111",1,892800,645455,247345,29,0.0644787870571852,1
"30129",1,1076400,844193,232207,25,0.0646092657945818,1
"30144",0,1136400,841419,294981,27,0.0491818935584977,1
"30147",0,558000,402134,155866,21,0.195301229118859,1
"30151",0,597600,455791,141809,42,0.0411706429261016,1
"30162",0,366000,268708,97292,24,0.215115725104669,1
"30178",0,421200,296511,124689,26,0.173510113924161,1
"30180",0,1346400,1043083,303317,34,0.0200516728286313,1
"30189",0,439200,322939,116261,52,0.0252182558997668,1
"30192",0,484800,358654,126146,25,0.16888839985564,1
"30199",0,454800,361933,92867,26,0.16699731556166,1
"30204",1,390000,287386,102614,38,0.0793832202900656,1
"30216",0,878400,671165,207235,28,0.0721578003268435,1
"30247",0,686400,515075,171325,33,0.0691114569863219,1
"30265",1,774000,535420,238580,47,0.0199751424429878,1
"30275",1,1120800,848062,272738,30,0.0405480569651608,1
"30284",1,836400,591076,245324,49,0.0153071073627416,1
"30285",0,506400,356677,149723,49,0.0279911558060636,1
"30286",0,441600,366828,74772,33,0.10595138791543,1
"30292",0,970800,709961,260839,23,0.0878493923415509,1
"30295",0,716400,548518,167882,54,0.0131263709180058,1
"30302",0,667200,462700,204500,58,0.0102906353206154,1
"30303",0,846000,657045,188955,41,0.0286739092616369,1
"30326",1,1156800,935173,221627,31,0.0360582910022688,1
"30350",0,1009200,698999,310201,34,0.0355320800709662,1
"30352",0,667200,561552,105648,23,0.148552425428944,1
"30374",0,519600,373968,145632,34,0.0849195448855007,1
"30377",0,540000,425865,114135,22,0.190449310387906,1
"30386",0,596400,482735,113665,29,0.10891917279364,1
"30387",0,1375200,1016606,358594,28,0.02973755048895,1
"30394",0,430800,312282,118518,20,0.249995801875717,1
"30396",0,553200,429206,123994,20,0.211603336706273,1
"30412",1,939600,743094,196506,44,0.019302475851504,1
"30444",0,1065600,806182,259418,54,0.00690579309306078,1
"30451",0,819600,630839,188761,47,0.0188353734282253,1
"30453",0,387600,250846,136754,22,0.233411794908769,1
"30471",0,922800,699303,223497,25,0.0831734028178458,1
"30472",0,433200,319892,113308,20,0.249599377044603,1
"30477",0,458400,346207,112193,24,0.188126403381989,1
"30484",0,634800,442642,192158,21,0.172924333657121,1
"30508",1,603600,439677,163923,33,0.079264936524129,1
"30525",1,1168800,902315,266485,27,0.0471045293231196,1
"30530",0,483600,339135,144465,22,0.204168845942756,1
"30532",0,730800,618870,111930,20,0.164981302361984,1
"30534",0,943200,696965,246235,30,0.0550925854251079,1
"30536",1,1327200,1091935,235265,38,0.0155805698486879,1
"30548",0,370800,262310,108490,20,0.271013471197663,1
"30550",0,535200,424846,110354,22,0.191984475595519,1
"30558",1,580800,420524,160276,40,0.0489358264943055,1
"30573",1,1150800,928819,221981,32,0.033732886458033,1
"30574",0,517200,382784,134416,35,0.079581422823069,1
"30580",1,1382400,1071798,310602,37,0.0148687120299194,1
"30585",0,406800,311858,94942,24,0.203444553769158,1
"30586",0,378000,274874,103126,20,0.26895116562835,1
"30605",0,924000,717580,206420,22,0.103687002308845,1
"30644",1,997200,799081,198119,40,0.0238501933505966,1
"30646",0,367200,283542,83658,28,0.166759573814424,1
"30658",0,396000,267897,128103,22,0.231405240892092,1
"30662",1,856800,648161,208639,49,0.0149933483286181,1
"30665",0,1174800,852563,322237,27,0.045650749278762,1
"30669",0,1401600,1107875,293725,32,0.0213908608928161,1
"30675",0,1377600,1072267,305333,22,0.0478187795200505,1
"30678",0,1221600,981782,239818,30,0.0346470115593011,1
"30680",1,1258800,957741,301059,38,0.0170807886605937,1
"30684",0,446400,310236,136164,20,0.24359961660863,1
"30690",0,819600,641834,177766,41,0.030121502312457,1
"30698",0,487200,360598,126602,29,0.128343108055211,1
"30699",0,564000,435413,128587,22,0.183181403101654,1
"30705",1,410400,311725,98675,35,0.0956441225603227,1
"30716",0,380400,327538,52862,27,0.176520525273147,1
"30720",1,702000,467695,234305,26,0.109397913187763,1
"30728",0,601200,423635,177565,22,0.170829151307848,1
"30748",0,1045200,832494,212706,30,0.0470954632916481,1
"30756",0,694800,554905,139895,36,0.0551556090393612,1
"30764",0,577200,444352,132848,21,0.191493770425512,1
"30772",0,409200,322455,86745,27,0.167402155509733,1
"30783",1,554400,450575,103825,40,0.052243854430019,1
"30796",0,643200,534167,109033,21,0.175603948592465,1
"30810",0,386400,303230,83170,39,0.0747375778497052,1
"30811",0,1275600,992810,282790,30,0.0310946574580801,1
"30814",1,1207200,892546,314654,35,0.0234470137640586,1
"30820",0,588000,404826,183174,49,0.0240362086855673,1
"30822",1,1236000,785409,450591,40,0.0143226558047011,1
"30835",0,1189200,856338,332862,23,0.0599892134242245,1
"30839",0,472800,325014,147786,52,0.0235186944109569,1
"30843",1,890400,716621,173779,27,0.0771176754985028,1
"30852",0,434400,356766,77634,26,0.172900794657256,1
"30857",1,676800,517545,159255,48,0.022523537846875,1
"30859",1,582000,430567,151433,47,0.028700134898237,1
"30863",1,1306800,907875,398925,30,0.0281849915269249,1
"30869",1,512400,360956,151444,35,0.079697266975104,1
"30884",1,946800,674029,272771,41,0.0233643314124182,1
"30887",0,526800,397907,128893,22,0.193116640863359,1
"30902",1,418800,313684,105116,50,0.0306039201099814,1
"30903",0,453600,330214,123386,26,0.165591776292832,1
"30908",0,454800,361249,93551,21,0.229680708352612,1
"30945",0,500400,363031,137369,21,0.212891206217616,1
"30951",0,547200,407526,139674,20,0.212308815845689,1
"30959",1,922800,735086,187714,26,0.0783425621539953,1
"30965",0,622800,501810,120990,20,0.1921610188122,1
"30976",1,1245600,908465,337135,34,0.0235191663111256,1
"30978",0,444000,325185,118815,22,0.217419368327025,1
"30981",0,446400,325328,121072,22,0.216551119975861,1
"31004",0,417600,280014,137586,23,0.210571189473775,1
"31008",1,752400,574617,177783,44,0.0267911158262061,1
"31011",1,366000,274885,91115,45,0.0492566231468163,1
"31026",0,852000,681992,170008,50,0.0141948257720176,1
"31029",1,470400,350528,119872,49,0.0301069984685335,1
"31049",0,1269600,860176,409424,50,0.00625386138530367,1
"31053",0,367200,250261,116939,24,0.21343505654176,1
"31054",1,1279200,957787,321413,25,0.0446292124979487,1
"31055",1,847200,658875,188325,47,0.0179652625642973,1
"31061",0,1305600,1016117,289483,53,0.00486126552329325,1
"31081",0,1194000,867819,326181,35,0.0238744720829428,1
"31092",1,931200,631791,299409,39,0.0277233071559294,1
"31107",0,1132800,777162,355638,30,0.0384884230590192,1
"31110",0,486000,354528,131472,24,0.179708906316717,1
"31112",0,481200,356108,125092,23,0.193424812318484,1
"31118",0,668400,491652,176748,20,0.176784252912275,1
"31119",0,927600,738264,189336,34,0.0427092026652218,1
"31126",0,547200,401121,146079,20,0.211879523236474,1
"31127",0,439200,332663,106537,22,0.21969676343239,1
"31132",0,664800,490182,174618,38,0.0492139028713131,1
"31134",0,1082400,799578,282822,40,0.0199363024115237,1
"31139",1,949200,664476,284724,33,0.0428459725580165,1
"31157",1,1272000,947558,324442,47,0.00816198810934347,1
"31169",1,582000,428555,153445,39,0.0528004135627907,1
"31171",0,418800,326209,92591,23,0.213233821799283,1
"31173",0,873600,663940,209660,24,0.0971944101988298,1
"31178",0,454800,327311,127489,23,0.200589470416628,1
"31191",0,402000,315225,86775,25,0.192684371412914,1
"31196",0,390000,294592,95408,58,0.0173486339002985,1
"31206",0,486000,386502,99498,30,0.121088879216477,1
"31207",0,1292400,920420,371980,21,0.0579026627027332,1
"31208",1,692400,502207,190193,36,0.0543293221580739,1
"31214",0,451200,329501,121699,24,0.189474535233193,1
"31215",1,590400,442638,147762,26,0.133928544051196,1
"31224",0,1297200,976007,321193,22,0.0543293719659873,1
"31232",1,556800,426472,130328,37,0.0644841430449322,1
"31236",1,1232400,922044,310356,39,0.0164719097866096,1
"31241",0,955200,657914,297286,20,0.110157280690453,1
"31252",1,1266000,914681,351319,37,0.0178822558072898,1
"31269",0,476400,391830,84570,23,0.197301588849317,1
"31272",0,568800,405895,162905,50,0.0231681054940924,1
"31275",0,813600,588595,225005,27,0.0856335882811931,1
"31277",0,790800,623427,167373,36,0.0465267407850115,1
"31285",0,1021200,777294,243906,49,0.01112655617679,1
"31300",0,499200,421079,78121,24,0.17945407115653,1
"31327",1,478800,338339,140461,47,0.0343394949474214,1
"31329",0,399600,284622,114978,24,0.204187621333152,1
"31359",1,864000,600589,263411,37,0.0367455513182892,1
"31362",1,591600,492916,98684,33,0.0827781525968803,1
"31368",0,1057200,849037,208163,47,0.0124060913182833,1
"31369",0,988800,649318,339482,47,0.0132566597250226,1
"31372",1,1008000,784245,223755,48,0.0124122913811227,1
"31379",0,436800,319022,117778,23,0.206331533103072,1
"31454",0,818400,654130,164270,47,0.0190570308259623,1
"31458",0,472800,348907,123893,54,0.0203231054618382,1
"31484",1,1389600,1026814,362786,45,0.00767097920749746,1
"31491",0,457200,359950,97250,25,0.177470726254561,1
"31509",1,1321200,1001836,319364,37,0.0164668576152155,1
"31534",0,570000,479006,90994,22,0.183865466856294,1
"31540",0,793200,625694,167506,41,0.0316283819897428,1
"31543",0,477600,373516,104084,20,0.235980578207894,1
"31546",0,428400,351504,76896,23,0.21147339102801,1
"31547",0,528000,414925,113075,22,0.193778465043909,1
"31548",0,710400,524176,186224,20,0.165801925639864,1
"31552",0,447600,360535,87065,24,0.1925959814088,1
"31567",0,852000,659852,192148,20,0.133987806313138,1
"31583",0,1231200,856914,374286,32,0.0277352935121565,1
"31584",0,534000,400793,133207,20,0.216642144825251,1
"31586",1,1071600,766007,305593,30,0.0434863233401462,1
"31588",1,1274400,937484,336916,25,0.0447227724878196,1
"31606",0,458400,362021,96379,23,0.201580687073571,1
"31614",0,1141200,750486,390714,56,0.00490554632918888,1
"31642",0,552000,423934,128066,32,0.09379594036487,1
"31649",1,1296000,1016302,279698,44,0.0100922360114294,1
"31657",0,698400,520365,178035,29,0.0905975411719568,1
"31661",0,490800,356690,134110,23,0.190256350432594,1
"31666",1,589200,414308,174892,42,0.0412278688433679,1
"31667",0,476400,360472,115928,23,0.195317291534029,1
"31680",0,463200,398828,64372,25,0.177861418265833,1
"31684",1,1194000,926546,267454,43,0.0130893993944521,1
"31687",1,1386000,1000702,385298,46,0.007070168291393,1
"31695",0,585600,439474,146126,22,0.176561446149451,1
"31698",0,1288800,1047657,241143,35,0.0209842965930308,1
"31702",0,910800,671971,238829,41,0.0251797230646266,1
"31713",1,721200,600523,120677,36,0.0531808745670074,1
"31716",0,487200,369175,118025,20,0.231963841004491,1
"31718",1,502800,396693,106107,34,0.088505589363062,1
"31728",0,381600,270340,111260,56,0.0204423266728606,1
"31729",0,763200,621260,141940,27,0.0956490036733449,1
"31734",0,751200,563090,188110,39,0.0392655933130358,1
"31748",0,483600,377919,105681,22,0.206707998019114,1
"31765",0,558000,411164,146836,20,0.208686776201577,1
"31781",0,555600,424833,130767,22,0.185261807506533,1
"31783",0,478800,352610,126190,23,0.194012819649726,1
"31796",0,1088400,789122,299278,27,0.0531803358648562,1
"31800",1,1369200,998423,370777,26,0.0348697828045493,1
"31821",0,560400,419065,141335,20,0.208356910828635,1
"31846",0,444000,326165,117835,22,0.217486253982508,1
"31855",0,1149600,898899,250701,37,0.0227183462689893,1
"31860",0,423600,326829,96771,25,0.186257209759117,1
"31869",0,1112400,864636,247764,42,0.0164237850023658,1
"31871",0,1176000,934783,241217,26,0.0506820022488819,1
"31874",0,374400,248686,125714,21,0.253100085947042,1
"31885",1,835200,625035,210165,27,0.0831691059972202,1
"31898",1,1081200,841579,239621,38,0.0237355803352319,1
"31905",1,1242000,1053122,188878,27,0.0429317509699917,1
"31908",0,398400,300018,98382,20,0.26234989149234,1
"31918",0,495600,373286,122314,34,0.089000127615582,1
"31919",0,510000,385275,124725,44,0.0412278615561446,1
"31944",1,787200,649336,137864,40,0.0349009758603665,1
"31951",0,1070400,783396,287004,44,0.0148689111678515,1
"31954",1,1395600,1057369,338231,40,0.0113619748348989,1
"31955",0,580800,474609,106191,23,0.168704528464516,1
"31967",0,765600,536364,229236,32,0.0639858569469914,1
"31995",0,442800,317733,125067,20,0.245587400572624,1
"32003",1,1282800,991313,291487,27,0.0385345602234944,1
"32005",0,1292400,1069592,222808,22,0.0568419655076229,1
"32023",1,992400,724998,267402,50,0.0107118112045231,1
"32028",0,462000,331299,130701,23,0.198369294932079,1
"32037",1,876000,665141,210859,39,0.0315190879647287,1
"32039",0,624000,505172,118828,20,0.191969316895638,1
"32050",0,544800,380294,164506,32,0.0936260601435422,1
"32056",0,492000,359081,132919,22,0.202534800074653,1
"32057",0,396000,274981,121019,23,0.218062031674708,1
"32068",1,746400,565288,181112,40,0.0367711939042227,1
"32077",1,876000,652881,223119,39,0.0313693312335579,1
"32078",0,364800,253578,111222,25,0.201444851596708,1
"32095",0,362400,268252,94148,22,0.244548081092615,1
"32106",0,565200,453490,111710,20,0.208930165929436,1
"32110",1,634800,458364,176436,39,0.0479379450840295,1
"32111",0,454800,337382,117418,21,0.227991439328139,1
"32118",1,951600,749907,201693,47,0.0149281279327163,1
"32120",1,886800,686094,200706,46,0.0180553689929821,1
"32122",0,465600,348555,117045,49,0.0303869398793122,1
"32128",0,516000,393424,122576,23,0.184241318397995,1
"32130",0,363600,284005,79595,23,0.230833020011356,1
"32143",0,1185600,918672,266928,23,0.0618629730535679,1
"32146",1,1248000,938120,309880,37,0.0187479649166911,1
"32147",1,1402800,1029029,373771,44,0.00807639628223412,1
"32149",1,1286400,1053240,233160,30,0.0311242852252116,1
"32155",1,750000,601992,148008,30,0.0784085218930761,1
"32159",0,474000,363879,110121,23,0.19634629240418,1
"32173",0,387600,301151,86449,27,0.172760550272234,1
"32179",0,768000,564571,203429,38,0.0409541765123589,1
"32192",1,828000,635524,192476,31,0.0630848510416602,1
"32196",0,1360800,1064877,295923,21,0.0532174139326589,1
"32204",1,1174800,815550,359250,42,0.0141120962852358,1
"32215",1,1207200,901183,306017,46,0.00995473427127388,1
"32222",1,544800,387898,156902,48,0.0282448548131994,1
"32228",0,822000,586215,235785,49,0.0157512888282182,1
"32240",1,958800,727239,231561,38,0.0293387411778401,1
"32248",0,534000,403862,130138,21,0.203663045518721,1
"32271",1,720000,574381,145619,41,0.0361057670960074,1
"32274",0,577200,414950,162250,60,0.0104522587236429,1
"32278",0,573600,437111,136489,57,0.0134470263522828,1
"32298",1,1369200,948015,421185,34,0.0184076520935043,1
"32299",0,549600,418725,130875,25,0.153298833073336,1
"32315",0,780000,582792,197208,30,0.0733410211036161,1
"32327",0,705600,488508,217092,20,0.165253491348054,1
"32333",0,541200,406716,134484,20,0.214422622270455,1
"32348",1,1254000,1006310,247690,47,0.00868228340130154,1
"32349",0,363600,253784,109816,28,0.16617902724001,1
"32350",0,542400,427697,114703,24,0.166531203422012,1
"32351",0,1215600,885151,330449,20,0.0718453094378338,1
"32358",0,435600,277928,157672,26,0.168063973895211,1
"32387",0,978000,690383,287617,44,0.0174321340886609,1
"32398",1,614400,487638,126762,46,0.0296221636382797,1
"32399",1,1405200,1024978,380222,34,0.0175834766075649,1
"32421",0,542400,402133,140267,24,0.165112933281002,1
"32424",0,477600,360492,117108,25,0.171180213014371,1
"32425",1,1413600,1119312,294288,41,0.0103597557524018,1
"32430",0,975600,710655,264945,46,0.0151059823222653,1
"32448",1,940800,765380,175420,47,0.015367597497162,1
"32457",0,673200,502073,171127,20,0.175890200152922,1
"32469",0,542400,400268,142132,24,0.165009844781745,1
"32474",1,825600,640888,184712,40,0.0321151164403113,1
"32476",0,542400,401895,140505,24,0.165099774875907,1
"32491",0,678000,532806,145194,21,0.16494350058738,1
"32514",0,427200,315482,111718,26,0.17274993081983,1
"32517",0,397200,322837,74363,27,0.171056179033905,1
"32518",1,1070400,801719,268681,26,0.059739326194964,1
"32527",0,702000,494872,207128,40,0.039232855036393,1
"32542",1,864000,646328,217672,33,0.0506816336001092,1
"32546",0,1410000,1028188,381812,27,0.0300029404938774,1
"32550",0,441600,325550,116050,24,0.192423009406464,1
"32551",1,991200,800535,190665,39,0.02611259840468,1
"32563",0,584400,466220,118180,40,0.0494304151420469,1
"32574",0,488400,373596,114804,24,0.180074807606112,1
"32582",0,1012800,801510,211290,28,0.0578062120968331,1
"32585",1,1074000,836658,237342,33,0.0353655648284549,1
"32592",0,1119600,791923,327677,43,0.0145347020270908,1
"32595",1,674400,481075,193325,45,0.0281530674882434,1
"32640",0,406800,313038,93762,23,0.21670264704464,1
"32652",1,529200,402409,126791,30,0.112166852402256,1
"32671",1,999600,741483,258117,35,0.0341292808531808,1
"32674",0,738000,517016,220984,46,0.023123458602957,1
"32685",0,1297200,981857,315343,28,0.0345180441954227,1
"32694",0,829200,604330,224870,40,0.0314256606252091,1
"32701",0,444000,347986,96014,25,0.18094546781743,1
"32702",0,642000,454326,187674,36,0.0591051011213489,1
"32705",0,394800,296857,97943,27,0.170312690937146,1
"32730",0,541200,394849,146351,21,0.200579992611785,1
"32733",0,480000,347613,132387,23,0.193296390595795,1
"32734",0,1417200,963040,454160,24,0.036288222622547,1
"32746",1,854400,646478,207922,43,0.0240356729997143,1
"32774",0,682800,526928,155872,28,0.10058919054764,1
"32779",0,482400,371090,111310,55,0.018584255344098,1
"32782",0,718800,501596,217204,45,0.0258586165617151,1
"32796",0,706800,494790,212010,20,0.165244631588067,1
"32798",0,560400,427302,133098,47,0.0299873269463795,1
"32803",0,1141200,812166,329034,38,0.0206788946245806,1
"32810",0,531600,414588,117012,48,0.0293388244727334,1
"32811",0,525600,408574,117026,57,0.0147224176781433,1
"32816",0,420000,332802,87198,21,0.241111775356268,1
"32825",1,997200,690177,307023,25,0.0715016873575331,1
"32826",0,360000,261546,98454,46,0.0459976872943503,1
"32838",0,694800,573271,121529,34,0.0644884011027697,1
"32843",0,849600,671208,178392,21,0.12610210680926,1
"32845",1,1017600,760143,257457,36,0.0306619464187874,1
"32893",0,476400,369707,106693,24,0.183687335803246,1
"32895",0,883200,612213,270987,33,0.0480987769965708,1
"32911",0,471600,313278,158322,24,0.181850568659308,1
"32912",0,499200,417533,81667,45,0.0395517378865201,1
"32937",0,585600,431833,153767,20,0.20036779329712,1
"32941",0,1386000,1025235,360765,34,0.0183138935102539,1
"32944",0,795600,559116,236484,22,0.125208905901146,1
"32947",1,1070400,827435,242965,37,0.0260908558071764,1
"32948",0,423600,293940,129660,26,0.172622976263453,1
"32951",0,368400,301263,67137,23,0.230227528009874,1
"32957",1,1234800,889950,344850,33,0.0258094198449376,1
"32970",0,945600,700606,244994,39,0.0276316620584037,1
"32980",0,400800,316160,84640,22,0.233013766713283,1
"32987",0,1291200,894209,396991,50,0.00605293070791349,1
"33005",0,840000,614947,225053,35,0.0452184219264832,1
"33007",1,1237200,960756,276444,36,0.020918780671516,1
"33015",0,420000,279820,140180,21,0.23724492816573,1
"33034",1,978000,753481,224519,35,0.0358620942139013,1
"33035",0,404400,311841,92559,21,0.245749590576772,1
"33040",0,368400,283924,84476,22,0.243324686146114,1
"33044",0,1089600,745570,344030,27,0.0521796894662441,1
"33045",0,589200,420415,168785,20,0.198399414715452,1
"33050",0,490800,380897,109903,60,0.0123942217442402,1
"33074",1,408000,294340,113660,35,0.0954880974989608,1
"33078",0,432000,274753,157247,23,0.205119063100866,1
"33096",1,1297200,1003483,293717,43,0.010834491979818,1
"33113",0,493200,373502,119698,24,0.178548341400266,1
"33129",0,570000,436680,133320,23,0.169835337814334,1
"33131",0,434400,358520,75880,20,0.252025055537686,1
"33137",1,1024800,718912,305888,48,0.0116704605111154,1
"33140",0,361200,283122,78078,51,0.0315775012972133,1
"33144",0,376800,288576,88224,26,0.187165660706565,1
"33153",0,454800,325008,129792,20,0.241365664383756,1
"33175",0,572400,436416,135984,21,0.19260355930203,1
"33182",0,436800,298180,138620,20,0.246529206023581,1
"33183",1,939600,635003,304597,44,0.0184986818137278,1
"33191",1,1096800,764293,332507,39,0.0206173503239447,1
"33193",1,890400,589472,300928,29,0.0634438874701659,1
"33195",0,708000,533234,174766,45,0.0267796340202084,1
"33197",0,1224000,1049347,174653,37,0.0206038778349019,1
"33228",0,447600,331472,116128,25,0.178824812065196,1
"33237",0,500400,382530,117870,25,0.16554450490688,1
"33246",0,812400,607885,204515,50,0.0149934005882626,1
"33273",0,564000,396444,167556,36,0.067686550730992,1
"33285",1,1090800,826526,264274,25,0.062345025232649,1
"33298",0,967200,637963,329237,40,0.0238495906344329,1
"33303",1,1267200,936951,330249,48,0.00758902099795496,1
"33306",0,541200,382414,158786,23,0.175585378660442,1
"33315",1,374400,297560,76840,37,0.0883747289565244,1
"33319",0,637200,498677,138523,21,0.175413622376265,1
"33328",1,1329600,864002,465598,38,0.0141664014388708,1
"33330",0,403200,282267,120933,23,0.215924508093323,1
"33336",1,397200,313277,83923,39,0.0734189761635659,1
"33377",1,1280400,1022367,258033,38,0.0167385433320502,1
"33385",1,576000,412262,163738,30,0.102881211521926,1
"33396",1,474000,387640,86360,38,0.0696930507600465,1
"33399",1,1366800,1063110,303690,43,0.00956462746420914,1
"33408",0,704400,520818,183582,20,0.167408698229288,1
"33415",1,1156800,941249,215551,31,0.036143091052439,1
"33422",0,1166400,926567,239833,41,0.0162312381967896,1
"33425",0,470400,357728,112672,21,0.223546593861963,1
"33448",1,1322400,1060422,261978,49,0.00654679001563889,1
"33459",0,584400,431151,153249,57,0.0131110284212147,1
"33460",1,1028400,769915,258485,25,0.0691998848054497,1
"33461",0,573600,388100,185500,22,0.177323554072767,1
"33482",0,650400,528940,121460,60,0.00935612901082133,1
"33490",0,466800,353272,113528,25,0.174087996919528,1
"33501",1,1386000,1095149,290851,30,0.0256857955502771,1
"33504",1,854400,643880,210520,28,0.0749328837690666,1
"33512",0,536400,444693,91707,21,0.205486990579316,1
"33523",1,901200,625166,276034,25,0.0844614725546552,1
"33528",1,667200,511222,155978,32,0.0771881329133902,1
"33537",0,968400,783720,184680,25,0.0783978078393412,1
"33541",0,574800,436519,138281,23,0.168374082478804,1
"33549",1,524400,410120,114280,39,0.0589469510177879,1
"33570",0,552000,392454,159546,47,0.0301071060230307,1
"33581",0,712800,547955,164845,31,0.076903098891462,1
"33594",0,1318800,917926,400874,26,0.0375283508313764,1
"33610",1,1100400,851019,249381,31,0.0392332441001482,1
"33614",0,422400,304566,117834,25,0.18529737486374,1
"33659",0,897600,659599,238001,53,0.0100899052983271,1
"33671",0,1123200,781786,341414,56,0.00516249123348879,1
"33673",1,807600,561951,245649,28,0.079778174211943,1
"33691",0,700800,499992,200808,42,0.0338144525948495,1
"33703",0,553200,417361,135839,20,0.21081185976738,1
"33708",0,471600,327152,144448,24,0.182679939495594,1
"33717",0,424800,331070,93730,20,0.253850568855518,1
"33727",1,658800,471010,187790,36,0.0574867228777495,1
"33729",0,824400,652094,172306,56,0.00928701965663261,1
"33731",1,1285200,909083,376117,40,0.0135487494226324,1
"33764",0,1284000,873042,410958,40,0.0133909972563112,1
"33765",0,481200,339609,141591,44,0.0429901220928166,1
"33774",0,408000,302923,105077,26,0.177999816485094,1
"33777",1,404400,325770,78630,28,0.158166953523118,1
"33779",1,1358400,947378,411022,37,0.0148947175882376,1
"33784",0,421200,318674,102526,24,0.198901330246969,1
"33787",0,554400,408055,146345,59,0.0118365118418211,1
"33799",1,913200,671784,241416,25,0.0839109431144923,1
"33805",1,841200,619730,221470,44,0.0226289398106484,1
"33806",0,422400,308105,114295,24,0.19781641587094,1
"33811",0,530400,405853,124547,20,0.218306646725579,1
"33820",1,963600,726877,236723,44,0.0182313809082816,1
"33827",1,520800,380624,140176,29,0.121318470676144,1
"33840",0,511200,398078,113122,22,0.19841557889028,1
"33861",1,448800,358732,90068,41,0.0580263880300381,1
"33877",0,675600,476268,199332,20,0.173652194122613,1
"33880",0,388800,303782,85018,27,0.172542204600834,1
"33881",0,547200,417074,130126,22,0.187532750806736,1
"33886",0,441600,346810,94790,20,0.248236378366616,1
"33913",1,746400,532567,213833,41,0.033629499317475,1
"33917",0,486000,373146,112854,23,0.192879100069598,1
"33920",1,1310400,925345,385055,35,0.0191083065914525,1
"33933",0,547200,401504,145696,23,0.17482491183032,1
"33940",1,1238400,913798,324602,30,0.0325866614405244,1
"33950",0,666000,518475,147525,42,0.0366104617895694,1
"33955",1,687600,489626,197974,46,0.0254321995589187,1
"33965",0,376800,276740,100060,24,0.211752664250839,1
"33988",0,403200,328359,74841,25,0.193102227061387,1
"33991",0,750000,579775,170225,59,0.00835133490358133,1
"34000",1,1350000,989941,360059,40,0.0121895101966663,1
"34006",1,1437600,1145922,291678,39,0.0116408120473322,1
"34010",0,865200,631810,233390,46,0.0184991987696187,1
"34013",0,808800,618396,190404,29,0.0755256250298827,1
"34017",1,1274400,878852,395548,42,0.0117094817589539,1
"34027",0,411600,269891,141709,26,0.174947942145821,1
"34034",0,856800,578845,277955,37,0.0369863508104403,1
"34059",0,424800,335738,89062,43,0.0519801793700062,1
"34075",1,410400,310312,100088,37,0.0827130596770638,1
"34094",1,614400,449736,164664,29,0.103974654523658,1
"34102",0,1251600,922471,329129,20,0.0677845787010227,1
"34112",1,1066800,767560,299240,29,0.0474056937144798,1
"34115",1,794400,579800,214600,43,0.0265597527863856,1
"34128",1,380400,276512,103888,27,0.173565302821105,1
"34143",0,724800,529995,194805,38,0.0441783924958754,1
"34175",1,1225200,864574,360626,31,0.0304281234575194,1
"34184",1,732000,558526,173474,38,0.0440072832100674,1
"34202",0,1015200,795002,220198,24,0.0771925397353856,1
"34204",1,1242000,943011,298989,46,0.00939762087715845,1
"34232",0,1350000,1043466,306534,32,0.0232506337930594,1
"34238",0,1106400,868480,237920,33,0.0334716950606687,1
"34243",1,729600,580823,148777,45,0.0260741563621291,1
"34270",0,378000,296818,81182,25,0.199668483999877,1
"34290",0,368400,310783,57617,23,0.230904912085384,1
"34307",1,934800,591676,343124,36,0.0341292037777403,1
"34310",0,378000,293597,84403,21,0.255044829446529,1
"34325",0,699600,516208,183392,41,0.0368293273574472,1
"34360",0,1208400,869655,338745,43,0.0124120178916349,1
"34361",1,876000,641141,234859,32,0.0532188413677729,1
"34373",0,640800,464000,176800,20,0.183929057128983,1
"34376",1,828000,594761,233239,49,0.0156048155682934,1
"34382",1,631200,460524,170676,34,0.0702479649638571,1
"34384",0,578400,428042,150358,23,0.166818384962573,1
"34429",1,1371600,1143892,227708,27,0.0339965296811663,1
"34434",0,958800,782855,175945,42,0.0219984987407568,1
"34463",0,1081200,808306,272894,35,0.0295472419439219,1
"34468",0,438000,334354,103646,21,0.234203042971402,1
"34480",0,495600,345853,149747,23,0.188004773705951,1
"34497",1,476400,319603,156797,45,0.0399262617827906,1
"34504",0,583200,423013,160187,20,0.200629096563875,1
"34505",1,1388400,1101883,286517,50,0.00534020654696777,1
"34510",1,429600,347760,81840,40,0.0647248651237908,1
"34519",0,399600,320368,79232,23,0.219849529972977,1
"34520",0,470400,393295,77105,24,0.187066880214544,1
"34539",1,620400,466595,153805,33,0.0774325259299662,1
"34546",1,979200,798985,180215,26,0.0716980674963964,1
"34568",0,378000,271741,106259,22,0.238650128736205,1
"34569",0,549600,425791,123809,20,0.212669947550728,1
"34588",0,1417200,1057960,359240,25,0.0348687807752548,1
"34596",1,1183200,860580,322620,39,0.0178418539159158,1
"34616",1,675600,475072,200528,48,0.0222075611815622,1
"34633",0,1330800,1008006,322794,29,0.0301064213697765,1
"34651",1,1196400,870569,325831,43,0.0127373729647161,1
"34656",1,650400,486113,164287,30,0.0914390303152851,1
"34661",0,374400,280248,94152,21,0.255500600023684,1
"34670",0,560400,403714,156686,46,0.0320913477123146,1
"34673",1,716400,469867,246533,43,0.0299568242905873,1
"34674",1,1164000,973699,190301,40,0.017969647074128,1
"34688",0,508800,413736,95064,20,0.226901328919084,1
"34715",1,842400,680129,162271,31,0.0623140799642979,1
"34716",0,466800,352333,114467,20,0.238651757841421,1
"34734",1,1104000,855187,248813,48,0.0104068481608981,1
"34743",0,402000,324094,77906,27,0.169666673249964,1
"34748",1,1011600,760851,250749,42,0.0195114362063669,1
"34753",1,1021200,817002,204198,33,0.0391579568190132,1
"34755",0,589200,440069,149131,20,0.199656058571739,1
"34759",1,1314000,897458,416542,38,0.0148381207658662,1
"34770",0,368400,285238,83162,26,0.18972695625206,1
"34772",0,518400,327761,190639,35,0.0777942872219838,1
"34779",1,925200,640668,284532,40,0.0260756630464327,1
"34786",0,384000,271360,112640,27,0.172161542456755,1
"34796",1,496800,358918,137882,25,0.165307198327467,1
"34798",0,561600,405189,156411,48,0.0274533222692047,1
"34801",0,741600,571762,169838,27,0.0979797378333053,1
"34805",0,482400,347814,134586,20,0.232278932378927,1
"34807",0,656400,466492,189908,28,0.103577580052179,1
"34821",1,982800,698412,284388,46,0.0148052643099922,1
"34825",0,520800,393118,127682,47,0.0321402229883921,1
"34846",0,768000,545549,222451,27,0.0921857915675967,1
"34873",1,464400,376031,88369,30,0.125664335516896,1
"34879",0,1360800,1117445,243355,26,0.0371541334436218,1
"34881",1,958800,731117,227683,27,0.0676328659997132,1
"34884",1,458400,305981,152419,35,0.0868874849979477,1
"34886",1,518400,381568,136832,27,0.139966311653435,1
"34902",1,427200,346449,80751,33,0.108133719831082,1
"34915",0,1201200,961767,239433,40,0.0165314325483063,1
"34922",0,442800,325754,117046,24,0.192034507669195,1
"34926",0,970800,759836,210964,48,0.0133043602892564,1
"34930",0,516000,377249,138751,21,0.208255632527798,1
"34933",0,420000,280622,139378,26,0.172967433913891,1
"34948",1,890400,624117,266283,31,0.055354824978726,1
"34969",1,1124400,786357,338043,48,0.00969539982414301,1
"34970",1,1158000,846368,311632,33,0.029800309107077,1
"34996",0,427200,329164,98036,29,0.141959988781961,1
"34997",0,500400,345300,155100,23,0.18639844996696,1
"35005",0,662400,503005,159395,20,0.179341435499125,1
"35010",0,404400,302938,101462,45,0.0460171777300495,1
"35013",0,801600,618561,183039,54,0.0112588651128305,1
"35016",1,1129200,870572,258628,33,0.0319452901439255,1
"35021",0,426000,309117,116883,51,0.0278595765979019,1
"35026",0,454800,336891,117909,26,0.165604792214698,1
"35044",1,1294800,969939,324861,29,0.0319781640192507,1
"35056",0,367200,272013,95187,26,0.189309089265571,1
"35057",0,428400,307190,121210,21,0.235960864645251,1
"35069",1,762000,521325,240675,49,0.0174332018429714,1
"35078",0,453600,357753,95847,25,0.178475836383159,1
"35095",0,379200,251432,127768,50,0.0324443278605978,1
"35105",1,1338000,1030311,307689,46,0.00792679949520058,1
"35107",1,858000,659944,198056,47,0.0175669617113651,1
"35120",0,1220400,831367,389033,22,0.0601161689736803,1
"35122",0,828000,597396,230604,53,0.0114170374149699,1
"35123",1,457200,359877,97323,42,0.0529426422436645,1
"35125",0,462000,359577,102423,22,0.213201883303455,1
"35128",0,1201200,913359,287841,42,0.013869110415334,1
"35132",1,474000,345066,128934,26,0.160412081349489,1
"35134",0,1282800,1029076,253724,21,0.0615087017973422,1
"35135",1,1035600,822659,212941,27,0.0599579535190899,1
"35140",1,579600,441920,137680,35,0.071844985453255,1
"35159",0,603600,445342,158258,22,0.171330968754124,1
"35172",0,984000,744049,239951,51,0.0101572866223256,1
"35175",1,1101600,852197,249403,34,0.0311091596243788,1
"35182",1,1260000,982719,277281,44,0.0107525625107494,1
"35187",1,1164000,907078,256922,28,0.0441784488332536,1
"35194",0,670800,546774,124026,20,0.179263176720484,1
"35200",1,1158000,896988,261012,35,0.026044275231854,1
"35203",0,633600,533002,100598,20,0.190498711556553,1
"35218",0,441600,311671,129929,21,0.231194658795802,1
"35242",1,1429200,1103023,326177,45,0.0072656134438155,1
"35254",0,522000,397530,124470,47,0.0321149036225598,1
"35270",0,381600,283931,97669,27,0.173621509964927,1
"35275",0,476400,365401,110999,22,0.208432146248442,1
"35280",0,570000,446822,123178,22,0.181936349558957,1
"35295",0,388800,304246,84554,24,0.209291884948793,1
"35305",1,436800,320951,115849,31,0.121110324992562,1
"35306",1,1099200,744260,354940,35,0.0277543171513361,1
"35317",1,1423200,1080655,342545,43,0.00853951139749094,1
"35352",0,756000,618901,137099,45,0.0250390183741818,1
"35356",0,469200,333075,136125,25,0.17218851174868,1
"35365",1,1135200,918506,216694,33,0.0321408881451054,1
"35370",0,1018800,689879,328921,55,0.00673428443957327,1
"35372",1,942000,781175,160825,28,0.0661849303316326,1
"35384",0,813600,605101,208499,57,0.00862143851204428,1
"35397",0,1222800,875584,347216,33,0.0263190367627335,1
"35434",0,1413600,1101904,311696,35,0.0164679745394357,1
"35437",0,478800,360955,117845,23,0.194536734679205,1
"35446",1,1184400,846019,338381,37,0.0206789784113023,1
"35463",0,481200,392639,88561,23,0.195720946966841,1
"35471",1,979200,733106,246094,46,0.015124638651417,1
"35474",1,381600,310696,70904,35,0.101106525770696,1
"35478",0,1134000,887591,246409,47,0.0106975548254302,1
"35486",1,530400,430761,99639,47,0.031967324457653,1
"35488",0,1014000,745331,268669,44,0.0165069347001534,1
"35509",0,925200,743039,182161,44,0.0198978134510015,1
"35535",1,1197600,894629,302971,39,0.0175403610230823,1
"35543",0,482400,354586,127814,23,0.192926958640365,1
"35550",1,1332000,941389,390611,42,0.0106181187065334,1
"35551",0,615600,466282,149318,21,0.180314306772225,1
"35566",0,546000,410747,135253,23,0.175734316178336,1
"35576",0,1238400,945662,292738,24,0.052090295348926,1
"35582",1,861600,623297,238303,38,0.0345072624201162,1
"35591",0,602400,459134,143266,21,0.184122271066673,1
"35600",0,463200,304936,158264,25,0.172421414273714,1
"35605",1,1287600,924178,363422,33,0.0234117499078381,1
"35651",0,1129200,773766,355434,35,0.0263655362798697,1
"35667",1,1026000,830725,195275,26,0.0660548821571022,1
"35671",0,888000,689406,198594,43,0.0227758303237652,1
"35673",1,1293600,938818,354782,33,0.0232511639499252,1
"35679",0,576000,451327,124673,20,0.204971330539706,1
"35697",0,364800,266314,98486,22,0.243451458906832,1
"35705",0,517200,362586,154614,21,0.206863349584825,1
"35707",0,800400,625862,174538,45,0.0228704996709095,1
"35722",1,774000,595388,178612,47,0.0204514637978089,1
"35725",0,774000,543208,230792,21,0.13890321178239,1
"35731",0,615600,483030,132570,21,0.181309262659753,1
"35739",1,394800,293932,100868,27,0.170146980184856,1
"35748",0,1221600,891482,330118,55,0.00472763025119442,1
"35751",0,507600,384097,123503,24,0.174657716351522,1
"35754",0,435600,343200,92400,24,0.195549776972828,1
"35758",0,752400,619661,132739,38,0.0431980959848145,1
"35762",1,1155600,915057,240543,31,0.0358681508880027,1
"35769",1,693600,532857,160743,41,0.037530823022315,1
"35791",0,656400,474808,181592,38,0.0497746922233482,1
"35799",0,1017600,732314,285286,38,0.0259917618611378,1
"35801",0,375600,306732,68868,26,0.188671229953119,1
"35804",0,472800,373521,99279,24,0.185083099700989,1
"35813",0,1065600,803882,261718,30,0.0446706862802082,1
"35820",0,855600,610902,244698,54,0.0100049471000939,1
"35828",0,883200,648360,234840,37,0.0359684635861018,1
"35831",0,1068000,787789,280211,44,0.0149707563588217,1
"35847",0,364800,268874,95926,23,0.229300344389882,1
"35850",1,510000,364239,145761,49,0.0278630627052183,1
"35856",0,531600,386479,145121,22,0.190802591209608,1
"35870",1,944400,719349,225051,34,0.0409554501417908,1
"35891",0,494400,369120,125280,24,0.177912489201969,1
"35894",1,1353600,1046999,306601,32,0.0231072122790227,1
"35898",0,427200,338954,88246,23,0.211065179214627,1
"35899",1,781200,624261,156939,30,0.0743015341353938,1
"35908",0,841200,713567,127633,31,0.0632552614721438,1
"35909",0,360000,259225,100775,27,0.178935595575062,1
"35919",1,1381200,1101636,279564,28,0.030354927420388,1
"35927",1,609600,455074,154526,48,0.0253135604073701,1
"35931",1,511200,391088,120112,48,0.0303374178882059,1
"35948",0,846000,570635,275365,34,0.0473705137758462,1
"35950",0,463200,305409,157791,24,0.184082518407269,1
"35956",0,578400,444462,133938,22,0.179120656132993,1
"35958",0,417600,309021,108579,33,0.108680678698779,1
"35964",1,633600,471877,161723,50,0.0207427025764816,1
"35966",0,476400,370863,105537,20,0.236254689328944,1
"35974",0,398400,276430,121970,25,0.191472622909162,1
"35980",1,1350000,1097675,252325,50,0.0057881240203515,1
"35981",0,373200,297535,75665,27,0.17702538888042,1
"35991",0,744000,568171,175829,32,0.0676284472976587,1
"35996",0,535200,427857,107343,20,0.218049095678421,1
"36007",0,400800,297357,103443,24,0.204598055771275,1
"36022",0,535200,364066,171134,22,0.188231223684562,1
"36023",0,415200,304644,110556,20,0.255762954380872,1
"36028",0,428400,325607,102793,23,0.209746561664197,1
"36039",0,556800,452331,104469,48,0.0282449827204352,1
"36040",0,969600,702290,267310,57,0.00642087155894008,1
"36045",0,434400,304721,129679,26,0.169936003983475,1
"36060",0,664800,467823,196977,54,0.0141864510377968,1
"36077",0,362400,256813,105587,44,0.0531383790487062,1
"36078",1,783600,542783,240817,36,0.0457852836328926,1
"36084",1,909600,684570,225030,37,0.0345294747810784,1
"36092",0,685200,471470,213730,32,0.0733807827300617,1
"36105",0,574800,398398,176402,23,0.166244011944198,1
"36116",0,598800,486075,112725,20,0.199301806049093,1
"36127",0,414000,287201,126799,25,0.186982248495878,1
"36137",0,366000,271442,94558,26,0.18967074726062,1
"36150",0,673200,477871,195329,34,0.0649876454752162,1
"36181",0,501600,395256,106344,24,0.177179415627405,1
"36189",0,373200,251463,121737,46,0.0445938307616834,1
"36191",0,907200,679026,228174,22,0.105627579922125,1
"36195",0,1388400,1059223,329177,34,0.0184666907351972,1
"36206",0,1228800,958486,270314,28,0.0394208541836453,1
"36209",1,1290000,903637,386363,35,0.0197797092032109,1
"36221",1,1122000,870737,251263,34,0.0300279547529029,1
"36228",0,421200,331128,90072,39,0.0704474911056122,1
"36232",0,400800,314371,86429,27,0.169481371502834,1
"36235",0,597600,416177,181423,20,0.195271399089165,1
"36239",1,583200,473402,109798,26,0.137190992961238,1
"36255",0,583200,420434,162766,21,0.188032541977568,1
"36256",0,511200,339401,171799,22,0.194699089903715,1
"36279",0,481200,397720,83480,20,0.236333469671323,1
"36298",0,362400,274085,88315,23,0.230585449365627,1
"36301",1,608400,407842,200558,42,0.0395258036226778,1
"36312",0,1184400,875286,309114,47,0.00956114715940807,1
"36318",0,362400,266614,95786,32,0.127527606248683,1
"36333",1,668400,455380,213020,47,0.0241784951138331,1
"36359",1,697200,531910,165290,44,0.0295750817371265,1
"36363",1,1268400,937490,330910,28,0.0360223552157659,1
"36392",0,474000,357218,116782,45,0.040709927210115,1
"36398",0,657600,465465,192135,20,0.178647615880235,1
"36405",0,602400,423407,178993,21,0.181979426952872,1
"36425",0,744000,584754,159246,46,0.0234475294158612,1
"36430",0,844800,656980,187820,20,0.135661788145977,1
"36433",1,782400,608993,173407,32,0.0635653125140078,1
"36438",1,564000,449065,114935,45,0.0350037297708812,1
"36441",0,606000,448139,157861,20,0.194445009697716,1
"36442",0,403200,282475,120725,24,0.202791687503583,1
"36448",0,836400,621065,215335,50,0.0143234775126782,1
"36450",0,434400,325765,108635,21,0.234976317973858,1
"36457",1,1356000,1053262,302738,41,0.0114089673855513,1
"36465",1,1285200,916828,368372,32,0.0253533603943568,1
"36479",0,970800,735563,235237,22,0.0953090122561118,1
"36491",0,625200,496503,128697,22,0.167672592598066,1
"36492",0,931200,671209,259991,28,0.06490785132652,1
"36495",1,585600,468952,116648,33,0.0830296308950109,1
"36499",0,573600,421316,152284,21,0.191263522672387,1
"36527",1,764400,620089,144311,46,0.022775833563798,1
"36530",0,398400,309917,88483,54,0.0234099462314733,1
"36535",0,452400,349575,102825,21,0.229766603400314,1
"36537",0,1048800,803386,245414,32,0.0397092654865415,1
"36545",1,897600,701310,196290,49,0.0140418130540676,1
"36555",0,558000,451814,106186,21,0.198451744312238,1
"36564",0,607200,461314,145886,44,0.0347123563978474,1
"36573",1,1382400,1077624,304776,32,0.022010903180616,1
"36574",0,997200,725947,271253,51,0.00980473205389433,1
"36591",0,633600,514157,119443,21,0.177442030810979,1
"36597",1,1364400,1056725,307675,41,0.0112221649588377,1
"36599",1,948000,661813,286187,42,0.0214608547757406,1
"36600",1,1435200,1076511,358689,40,0.0105226746129371,1
"36602",1,819600,633396,186204,49,0.0161291661329285,1
"36603",0,547200,420554,126646,21,0.200161923618479,1
"36619",1,1035600,740156,295444,31,0.0429776642331152,1
"36627",0,946800,680194,266606,26,0.0731842212796446,1
"36635",0,390000,269431,120569,22,0.233821160083598,1
"36656",1,787200,597329,189871,39,0.0369289566011328,1
"36663",0,703200,468299,234901,50,0.0178823617243475,1
"36665",0,1023600,715764,307836,21,0.0917331666481447,1
"36684",0,463200,372217,90983,26,0.165064093314222,1
"36697",0,386400,282715,103685,20,0.2660235172644,1
"36700",1,483600,357947,125653,32,0.104580840325376,1
"36707",0,403200,301663,101537,42,0.0578000769978508,1
"36715",1,686400,544096,142304,33,0.0698640673394014,1
"36718",1,988800,732518,256282,46,0.0148163563115751,1
"36726",0,406800,308466,98334,26,0.178704246370831,1
"36733",0,373200,282753,90447,21,0.256183807353344,1
"36743",1,525600,400374,125226,25,0.159139770629085,1
"36773",0,571200,396215,174985,20,0.203060122106749,1
"36778",1,604800,440279,164521,45,0.0320450379282741,1
"36781",0,772800,591607,181193,40,0.0351664156274338,1
"36784",1,780000,652571,127429,37,0.0445919813168174,1
"36798",0,709200,520982,188218,31,0.0766856653533403,1
"36827",1,1034400,791393,243007,32,0.0407203012954117,1
"36836",0,366000,284653,81347,21,0.259295422547752,1
"36857",0,367200,249921,117279,21,0.256136325217876,1
"36860",0,530400,408323,122077,24,0.169054094569062,1
"36862",1,652800,459771,193029,32,0.0779300207898513,1
"36875",1,1069200,796244,272956,50,0.00935516502947437,1
"36876",0,556800,439144,117656,20,0.210975829083837,1
"36877",0,502800,401883,100917,57,0.0154109930409805,1
"36880",1,378000,309301,68699,47,0.0418415896643025,1
"36885",1,1154400,855800,298600,34,0.0278983612380225,1
"36894",0,472800,331078,141722,22,0.207441509764125,1
"36898",1,1335600,884572,451028,48,0.00642112350746507,1
"36909",1,1066800,856439,210361,50,0.00963074932525984,1
"36914",1,968400,786976,181424,28,0.0628941622223346,1
"36916",0,842400,701489,140911,23,0.112334796052645,1
"36938",1,478800,346350,132450,25,0.170012065012609,1
"36941",1,757200,558024,199176,43,0.0284685106996093,1
"36948",0,513600,387655,125945,33,0.0928388128947823,1
"36954",0,810000,585806,224194,21,0.13183178201156,1
"36964",1,674400,490765,183635,38,0.0482663934679464,1
"36974",1,448800,326154,122646,26,0.166798320292133,1
"36976",0,495600,349675,145925,24,0.176398976547527,1
"36978",1,736800,580485,156315,42,0.0323674892308464,1
"37017",0,500400,374223,126177,50,0.0264173025084886,1
"37023",0,920400,654023,266377,43,0.0209802438296984,1
"37031",1,558000,371530,186470,47,0.0294909955061577,1
"37035",0,520800,412170,108630,24,0.172197507538516,1
"37052",0,435600,324454,111146,23,0.2071125225809,1
"37054",0,424800,286483,138317,23,0.208433446642636,1
"37056",0,490800,337102,153698,59,0.0131749581040477,1
"37061",0,381600,284847,96753,34,0.107559689393721,1
"37074",0,420000,311113,108887,23,0.211788168775206,1
"37101",0,1156800,843328,313472,43,0.0137068812243498,1
"37105",1,364800,276304,88496,26,0.190368564048878,1
"37111",0,1027200,791586,235614,48,0.0119503215072895,1
"37145",0,690000,465847,224153,20,0.168661012897685,1
"37151",0,1266000,918386,347614,45,0.00956564208167068,1
"37152",1,1263600,982555,281045,46,0.00911655421566147,1
"37160",1,1044000,773791,270209,32,0.0396507844658292,1
"37170",0,546000,396886,149114,22,0.18669418392625,1
"37187",0,362400,269808,92592,20,0.275200983087502,1
"37191",1,445200,307551,137649,35,0.0892202194613863,1
"37194",0,576000,439617,136383,20,0.204207033814978,1
"37195",1,700800,538597,162203,30,0.0844272581428455,1
"37215",0,1263600,1008564,255036,35,0.0217917179454018,1
"37221",0,1050000,816472,233528,26,0.0626011842868339,1
"37235",0,378000,267062,110938,22,0.238309314860157,1
"37239",0,460800,369794,91006,22,0.214324857148047,1
"37250",0,472800,340156,132644,23,0.19525491839566,1
"37251",0,812400,677677,134723,42,0.0287067425327546,1
"37255",0,505200,381585,123615,20,0.226000305528139,1
"37257",1,446400,328226,118174,31,0.119233359866449,1
"37264",0,480000,368175,111825,21,0.220699065290182,1
"37287",0,638400,504349,134051,20,0.187155447497002,1
"37305",0,444000,335260,108740,23,0.204863203653857,1
"37308",1,432000,307128,124872,44,0.0469790815084054,1
"37314",0,428400,345213,83187,23,0.211052948310312,1
"37327",0,1180800,876462,304338,29,0.0390818628225881,1
"37341",0,1233600,833395,400205,38,0.0171546047774537,1
"37346",0,898800,675259,223541,45,0.0189497677837801,1
"37354",0,388800,297935,90865,22,0.236341509026522,1
"37357",0,825600,615231,210369,52,0.0125005756151171,1
"37359",1,475200,360376,114824,48,0.0323151649499798,1
"37392",0,1411200,1093726,317474,23,0.0417055584226122,1
"37413",0,412800,284520,128280,47,0.0385683268672857,1
"37433",1,1099200,830440,268760,42,0.0166630537101287,1
"37438",0,932400,680926,251474,46,0.0163611436934186,1
"37449",0,688800,492844,195956,43,0.0320172308824231,1
"37465",0,1279200,990980,288220,37,0.0179205834151392,1
"37466",0,734400,588567,145833,54,0.012835611810805,1
"37480",0,536400,437866,98534,20,0.218293116317572,1
"37489",1,1279200,979537,299663,30,0.0307031431588405,1
"37508",1,422400,298384,124016,38,0.0747365833772132,1
"37528",1,1194000,897426,296574,27,0.0446443019951498,1
"37540",1,1042800,791361,251439,47,0.0125029248112374,1
"37542",1,846000,657226,188774,43,0.0245667118939642,1
"37552",0,483600,357094,126506,21,0.218608641468537,1
"37566",0,1348800,1077421,271379,40,0.0126515312008201,1
"37567",0,1411200,1047016,364184,32,0.0204672742751902,1
"37586",0,454800,359380,95420,23,0.202659919202436,1
"37601",0,505200,397754,107446,57,0.0153077954578019,1
"37618",1,966000,723999,242001,34,0.0392374261305538,1
"37633",0,507600,380245,127355,20,0.225003909897583,1
"37667",0,1038000,808244,229756,23,0.0797715176026651,1
"37671",0,553200,413318,139882,20,0.210542205697854,1
"37672",0,613200,495211,117989,21,0.18280630367118,1
"37677",0,584400,416480,167920,59,0.0111414881435267,1
"37681",0,507600,356552,151048,23,0.184737522941529,1
"37685",0,574800,455106,119694,22,0.180894936405674,1
"37703",1,692400,544041,148359,34,0.0640940105384156,1
"37705",1,639600,442449,197151,48,0.023650540840572,1
"37740",0,412800,291022,121778,23,0.213033622516991,1
"37748",1,361200,287836,73364,42,0.0626003058161356,1
"37773",0,649200,506298,142902,21,0.17214274830136,1
"37779",1,532800,368568,164232,27,0.135662911986811,1
"37794",0,508800,377772,131028,23,0.185631870925185,1
"37797",0,1395600,1010526,385074,37,0.0141120629441363,1
"37801",0,474000,354682,119318,40,0.0593276075235021,1
"37804",0,423600,287424,136176,21,0.236395173661877,1
"37813",0,723600,524523,199077,40,0.0379486544996381,1
"37820",0,1171200,876249,294951,28,0.0430165183769216,1
"37826",0,649200,486371,162829,32,0.0792639717153886,1
"37828",0,916800,672954,243846,33,0.0459488126735923,1
"37833",1,1327200,985165,342035,43,0.0100899991651489,1
"37837",1,1027200,698012,329188,26,0.0626939961620591,1
"37838",0,1161600,893855,267745,55,0.00538119084523855,1
"37843",0,595200,490560,104640,53,0.0179376038932912,1
"37857",0,583200,417436,165764,21,0.187849026927258,1
"37859",1,560400,392450,167950,32,0.0912176470453303,1
"37891",0,528000,396389,131611,59,0.0124624517372045,1
"37904",1,597600,437520,160080,49,0.0238595552807881,1
"37910",0,397200,301690,95510,27,0.169856869188398,1
"37936",0,961200,710403,250797,51,0.0105215028479708,1
"37937",1,1072800,757090,315710,48,0.0106974434289595,1
"37950",0,738000,568724,169276,47,0.0218338656999039,1
"37952",0,416400,283692,132708,52,0.0260512193897473,1
"37959",1,1026000,772187,253813,29,0.0516251309833957,1
"37961",0,408000,309325,98675,27,0.167028623836494,1
"37967",0,453600,354738,98862,22,0.215922843574576,1
"37969",0,1414800,985210,429590,31,0.0214290601729611,1
"37977",0,385200,296306,88894,20,0.267595317700303,1
"37978",1,974400,754025,220375,28,0.0613712843732185,1
"37994",0,721200,544929,176271,29,0.0874160628165538,1
"37999",0,403200,310594,92606,49,0.0341003856014007,1
"38007",0,418800,295875,122925,20,0.253623921229439,1
"38010",0,453600,317615,135985,24,0.187953503040789,1
"38017",0,434400,320286,114114,22,0.220618915697515,1
"38021",1,1317600,1002015,315585,37,0.0165940408890691,1
"38023",0,606000,446438,159562,20,0.194338168900657,1
"38030",0,381600,300132,81468,21,0.254071297543579,1
"38038",0,387600,294206,93394,47,0.0407831903647525,1
"38039",0,874800,713147,161653,54,0.0100016534855553,1
"38041",1,1351200,906698,444502,36,0.0160935657616217,1
"38043",1,700800,467358,233442,33,0.0659543079142129,1
"38055",0,512400,388994,123406,33,0.0931019853114396,1
"38058",0,451200,360633,90567,54,0.0213681789552776,1
"38074",0,394800,273868,120932,26,0.180466586695763,1
"38075",1,985200,779621,205579,42,0.0207817772452486,1
"38082",0,404400,326348,78052,26,0.180522525181224,1
"38095",1,709200,524700,184500,26,0.110117130326016,1
"38098",1,400800,294615,106185,43,0.0537415006554974,1
"38102",0,1005600,786727,218873,43,0.0184657999808906,1
"38133",0,544800,403303,141497,21,0.199881675632825,1
"38134",0,606000,434224,171776,22,0.169968503423985,1
"38136",0,656400,495183,161217,21,0.169316716759462,1
"38146",1,1125600,894744,230856,32,0.0350813620488172,1
"38165",0,364800,237463,127337,29,0.154265990248396,1
"38172",0,1075200,756145,319055,24,0.0674904483627821,1
"38186",1,998400,697794,300606,48,0.0122418029021846,1
"38211",0,482400,355140,127260,56,0.0170816316307855,1
"38213",0,624000,435411,188589,31,0.0879340717603572,1
"38217",1,1219200,851856,367344,34,0.0243160929422288,1
"38234",0,363600,247814,115786,26,0.189009342950325,1
"38237",0,499200,352683,146517,23,0.187240833056053,1
"38238",1,382800,302852,79948,35,0.100586959525174,1
"38240",0,1003200,782030,221170,38,0.0273131415274051,1
"38249",1,1198800,945038,253762,28,0.0417247823499136,1
"38251",0,460800,324627,136173,22,0.211290165396338,1
"38260",1,493200,397604,95596,47,0.0341003620428811,1
"38286",0,657600,480999,176601,20,0.179563647333221,1
"38290",1,1300800,997799,303001,27,0.0372171244811687,1
"38332",1,1368000,1055536,312464,35,0.0178078957969506,1
"38346",0,608400,468397,140003,46,0.0297720567192363,1
"38359",1,596400,398684,197716,28,0.113437804898139,1
"38363",0,1216800,968036,248764,21,0.0686593967808947,1
"38371",0,742800,565441,177359,21,0.148257561719838,1
"38372",1,456000,342584,113416,31,0.11767624014929,1
"38378",1,661200,498174,163026,37,0.0536204908538479,1
"38380",0,958800,655023,303777,47,0.0141606504771353,1
"38383",0,442800,326122,116678,21,0.231766099441526,1
"38417",0,678000,540984,137016,42,0.0360221591969056,1
"38418",0,489600,362331,127269,22,0.203581994962851,1
"38421",1,843600,675824,167776,37,0.0394602963727186,1
"38426",0,730800,544531,186269,60,0.00792964453895009,1
"38439",1,1417200,987986,429214,26,0.0314262509000363,1
"38441",0,400800,277511,123289,22,0.230254863786492,1
"38461",0,1017600,748766,268834,30,0.0482690429598655,1
"38466",0,1300800,896123,404677,43,0.0103032587340304,1
"38472",0,910800,635279,275521,58,0.00655159624287114,1
"38474",1,494400,356921,137479,33,0.095311421611956,1
"38485",0,963600,688618,274982,48,0.0131339861074406,1
"38499",0,570000,398188,171812,55,0.015605067984229,1
"38502",1,1030800,756098,274702,28,0.0547803485635505,1
"38519",0,565200,417267,147933,22,0.181710426759039,1
"38521",0,998400,809720,188680,45,0.0161849049292256,1
"38536",1,1008000,824409,183591,41,0.0217880819642457,1
"38537",0,1147200,935188,212012,21,0.0779321322239596,1
"38539",0,566400,397294,169106,23,0.168704002947448,1
"38547",0,682800,562204,120596,20,0.176390388005377,1
"38569",0,410400,306736,103664,24,0.201860099962946,1
"38573",0,1149600,811108,338492,50,0.00792653308492095,1
"38590",0,366000,263905,102095,27,0.17731907554536,1
"38591",0,878400,712366,166034,40,0.0295749700247671,1
"38592",0,475200,314004,161196,21,0.218746037033757,1
"38599",1,548400,420865,127535,30,0.108831276695736,1
"38612",0,944400,731512,212888,37,0.0327072194514553,1
"38631",1,366000,298056,67944,29,0.157120929753785,1
"38647",0,889200,734635,154565,34,0.0461563052550693,1
"38653",0,1022400,776807,245593,32,0.0415082828462249,1
"38658",1,872400,679865,192535,44,0.0216959058159286,1
"38660",0,439200,328088,111112,24,0.1933860540735,1
"38685",0,1436400,1002469,433931,41,0.00942081003912716,1
"38690",0,537600,402342,135258,20,0.21543454038632,1
"38705",0,392400,324613,67787,23,0.222814758890413,1
"38715",0,500400,378970,121430,21,0.213964407739802,1
"38719",0,520800,369655,151145,31,0.104959886613668,1
"38735",0,591600,431757,159843,21,0.185973233488304,1
"38737",0,363600,297354,66246,22,0.246231011499578,1
"38741",0,1407600,1096484,311116,43,0.00888437566376897,1
"38746",0,1156800,844713,312087,39,0.0187483111278365,1
"38747",0,397200,266418,130782,40,0.0670097273600614,1
"38768",0,984000,834067,149933,42,0.0212846022945822,1
"38777",1,1224000,858139,365861,36,0.020659523859209,1
"38779",0,1414800,1184972,229828,43,0.00906211690230481,1
"38789",0,465600,347468,118132,20,0.238766710985107,1
"38790",1,703200,561989,141211,38,0.0467530435216767,1
"38793",0,405600,342672,62928,23,0.219168791759221,1
"38797",0,705600,535317,170283,46,0.0249306778197589,1
"38823",0,520800,386098,134702,40,0.0545940961974767,1
"38827",1,1096800,776215,320585,31,0.0384030618944288,1
"38833",1,872400,675883,196517,39,0.0318893097162959,1
"38848",1,9e+05,715074,184926,37,0.0356433981669626,1
"38858",1,598800,457370,141430,25,0.141924690167334,1
"38865",0,424800,311249,113551,57,0.017540497657202,1
"38881",0,415200,317780,97420,51,0.0285926945735498,1
"38886",0,494400,355909,138491,21,0.214582249313299,1
"38905",1,1111200,859686,251514,30,0.0415451491490802,1
"38907",0,697200,545221,151979,47,0.0235730880199875,1
"38922",1,506400,346786,159614,46,0.0351240895049256,1
"38923",0,498000,344188,153812,28,0.133995831892943,1
"38939",0,667200,511023,156177,20,0.178296007266045,1
"38951",0,699600,519708,179892,28,0.0971093051625546,1
"38952",0,375600,246641,128959,27,0.173329411185239,1
"38958",0,651600,480368,171232,20,0.181437187203597,1
"38961",0,441600,298760,142840,26,0.167426840983652,1
"38971",0,620400,506442,113958,22,0.169680816782988,1
"38983",1,1297200,931710,365490,47,0.00768562359016072,1
"39010",0,1293600,1125807,167793,32,0.0270292858811065,1
"39011",0,381600,267715,113885,20,0.266867686033194,1
"39027",0,966000,647109,318891,28,0.0599583993764583,1
"39042",1,1168800,917571,251229,35,0.0256665062155534,1
"39044",1,525600,391973,133627,45,0.0370802347499937,1
"39046",0,1168800,827267,341533,47,0.00969780763593413,1
"39069",1,1095600,884448,211152,31,0.0401380678963999,1
"39092",1,885600,640241,245359,38,0.0330428440497025,1
"39098",0,1026000,720690,305310,50,0.00995462637625804,1
"39106",0,480000,370838,109162,25,0.171035822551203,1
"39112",0,1399200,1185984,213216,32,0.0221683280307778,1
"39119",0,519600,413867,105733,20,0.22285714442783,1
"39121",0,1395600,1067682,327918,40,0.0114085318958063,1
"39139",1,805200,548094,257106,32,0.0593270743820416,1
"39141",1,1233600,928607,304993,45,0.010291385127247,1
"39147",0,364800,254766,110034,29,0.155173598173143,1
"39151",0,920400,693239,227161,38,0.0313702230547333,1
"39153",1,630000,489234,140766,44,0.0334647625303797,1
"39157",0,415200,314718,100482,45,0.0452105440243888,1
"39166",0,712800,522228,190572,23,0.134708058661088,1
"39190",0,1334400,1077696,256704,29,0.0307018890860415,1
"39204",1,1414800,994042,420758,43,0.00839967285898358,1
"39215",1,656400,499968,156432,32,0.0785336485749758,1
"39224",1,459600,349309,110291,30,0.125622325173159,1
"39227",1,512400,399150,113250,39,0.0601474862804681,1
"39253",0,728400,464236,264164,30,0.077779103388389,1
"39257",1,1057200,794628,262572,40,0.0209837380904846,1
"39267",1,879600,697298,182302,49,0.0145655087283131,1
"39280",0,1102800,820290,282510,47,0.0111313196091587,1
"39291",1,1303200,888890,414310,37,0.0163612205772696,1
"39298",0,1026000,785244,240756,32,0.0413348667033404,1
"39313",0,495600,358674,136926,24,0.176923960000197,1
"39318",0,589200,437878,151322,20,0.199515674366397,1
"39340",0,747600,592657,154943,59,0.00843735602001351,1
"39363",0,481200,353328,127872,25,0.169678056860447,1
"39390",1,715200,517779,197421,42,0.0330431575267531,1
"39392",0,382800,296032,86768,45,0.0479758746251417,1
"39415",0,488400,386843,101557,24,0.180860610992944,1
"39419",1,1030800,747111,283689,45,0.014741561083534,1
"39429",1,430800,302069,128731,34,0.0984166329135471,1
"39433",1,1111200,787854,323346,40,0.0186736968957261,1
"39446",0,876000,707510,168490,36,0.0403177285087169,1
"39470",1,1423200,1099874,323326,40,0.0108956539173699,1
"39476",0,370800,282283,88517,22,0.242253656899289,1
"39477",0,596400,454823,141577,55,0.0150893730291419,1
"39478",0,381600,263035,118565,25,0.196286305846604,1
"39488",1,676800,503908,172892,32,0.0755235059835018,1
"39497",0,363600,264412,99188,27,0.178103936084595,1
"39505",0,547200,435932,111268,29,0.117671829273674,1
"39508",0,477600,377525,100075,24,0.183770095282002,1
"39511",0,1142400,845941,296459,20,0.0819007960515987,1
"39514",0,424800,297244,127556,23,0.20914643923594,1
"39521",0,438000,307919,130081,22,0.218440967494273,1
"39537",1,1364400,1036022,328378,38,0.0140837285793961,1
"39554",1,499200,364389,134811,26,0.154246598125552,1
"39555",0,481200,346391,134809,21,0.218758122072869,1
"39573",0,1201200,888166,313034,31,0.0322845677384902,1
"39578",0,998400,738308,260092,32,0.0429741009943514,1
"39580",0,364800,294802,69998,24,0.217327222894854,1
"39583",0,378000,283541,94459,22,0.239511114582963,1
"39596",0,458400,341659,116741,39,0.0656379382283255,1
"39599",1,1250400,1019761,230639,45,0.0102953242704815,1
"39600",0,454800,345991,108809,23,0.201793561955211,1
"39605",0,1165200,917723,247477,30,0.0379960679655933,1
"39625",1,1087200,747291,339909,27,0.0524701640624391,1
"39636",0,596400,474451,121949,21,0.187003111462882,1
"39639",0,753600,570122,183478,49,0.0180901205316866,1
"39646",0,818400,632225,186175,27,0.0861961907800226,1
"39659",0,813600,612825,200775,34,0.0514393883911946,1
"39698",0,564000,405514,158486,20,0.20619023923469,1
"39704",0,937200,656182,281018,55,0.00791065601781191,1
"39705",1,742800,545450,197350,27,0.0968248062624044,1
"39707",0,1050000,746547,303453,36,0.0285036004440866,1
"39711",0,638400,472650,165750,36,0.0599504968189742,1
"39713",1,1161600,826678,334922,44,0.0124622266006814,1
"39717",1,1399200,971124,428076,29,0.0257177919269474,1
"39722",1,532800,395530,137270,38,0.062102386198631,1
"39725",0,380400,290698,89702,56,0.020658682698037,1
"39737",1,1047600,786697,260903,38,0.0249303359740296,1
"39739",0,1234800,988011,246789,49,0.00767078279448164,1
"39754",1,459600,340072,119528,30,0.12521595133129,1
"39758",0,1384800,1023059,361741,40,0.0114691077337752,1
"39765",0,1122000,848100,273900,31,0.0374749768156248,1
"39769",0,512400,354411,157989,29,0.122128092476005,1
"39801",0,362400,261179,101221,24,0.215915708512093,1
"39805",0,529200,401494,127706,24,0.169032299238954,1
"39816",0,799200,596750,202450,30,0.0709486065984223,1
"39824",1,1102800,783244,319556,36,0.0258872481822581,1
"39835",1,458400,343109,115291,36,0.0819007394521647,1
"39846",1,1129200,873562,255638,38,0.0217259359110306,1
"39851",0,525600,399755,125845,20,0.21965596774161,1
"39856",0,367200,274765,92435,22,0.243124112829008,1
"39879",0,374400,286048,88352,20,0.271363184649302,1
"39897",0,1308000,904013,403987,28,0.032747871233052,1
"39905",0,1384800,1040125,344675,40,0.0115469715970163,1
"39912",1,1189200,845315,343885,45,0.0109445470318201,1
"39923",0,1362000,957116,404884,22,0.0472485479148748,1
"39926",0,441600,336478,105122,24,0.193105031045682,1
"39927",0,595200,406540,188660,43,0.0376147946440198,1
"39928",1,1374000,1113215,260785,32,0.0227184140422337,1
"39932",0,948000,772828,175172,28,0.0651866303151029,1
"39965",0,549600,407344,142256,56,0.0151233277270794,1
"39968",0,825600,649054,176546,60,0.00675036754831286,1
"39971",0,1374000,1159895,214105,28,0.031520114533755,1
"39972",0,528000,414943,113057,23,0.181669161009974,1
"39986",0,855600,634552,221048,25,0.0926863103427643,1
"40001",1,0,0,0,0,0.784583331571564,1
"40002",1,0,0,0,0,0.784583331571564,1
"40003",1,0,0,0,0,0.784583331571564,1
"40004",1,0,0,0,0,0.784583331571564,1
"40005",1,0,0,0,0,0.784583331571564,1
"40006",1,0,0,0,0,0.784583331571564,1
"40007",1,0,0,0,0,0.784583331571564,1
"40008",1,0,0,0,0,0.784583331571564,1
"40009",1,0,0,0,0,0.784583331571564,1
"40010",1,0,0,0,0,0.784583331571564,1
"40011",1,0,0,0,0,0.784583331571564,1
"40012",1,0,0,0,0,0.784583331571564,1
"40013",1,0,0,0,0,0.784583331571564,1
"40014",1,0,0,0,0,0.784583331571564,1
"40015",1,0,0,0,0,0.784583331571564,1
"40016",1,0,0,0,0,0.784583331571564,1
"40017",1,0,0,0,0,0.784583331571564,1
"40018",1,0,0,0,0,0.784583331571564,1
"40019",1,0,0,0,0,0.784583331571564,1
"40020",1,0,0,0,0,0.784583331571564,1
"40021",1,0,0,0,0,0.784583331571564,1
"40022",1,0,0,0,0,0.784583331571564,1
"40023",1,0,0,0,0,0.784583331571564,1
"40024",1,0,0,0,0,0.784583331571564,1
"40025",1,0,0,0,0,0.784583331571564,1
"40026",1,0,0,0,0,0.784583331571564,1
"40027",1,0,0,0,0,0.784583331571564,1
"40028",1,0,0,0,0,0.784583331571564,1
"40029",1,0,0,0,0,0.784583331571564,1
"40030",1,0,0,0,0,0.784583331571564,1
"40031",1,0,0,0,0,0.784583331571564,1
"40032",1,0,0,0,0,0.784583331571564,1
"40033",1,0,0,0,0,0.784583331571564,1
"40034",1,0,0,0,0,0.784583331571564,1
"40035",1,0,0,0,0,0.784583331571564,1
"40036",1,0,0,0,0,0.784583331571564,1
"40037",1,0,0,0,0,0.784583331571564,1
"40038",1,0,0,0,0,0.784583331571564,1
"40039",1,0,0,0,0,0.784583331571564,1
"40040",1,0,0,0,0,0.784583331571564,1
"40041",1,0,0,0,0,0.784583331571564,1
"40042",1,0,0,0,0,0.784583331571564,1
"40043",1,0,0,0,0,0.784583331571564,1
"40044",1,0,0,0,0,0.784583331571564,1
"40045",1,0,0,0,0,0.784583331571564,1
"40046",1,0,0,0,0,0.784583331571564,1
"40047",1,0,0,0,0,0.784583331571564,1
"40048",1,0,0,0,0,0.784583331571564,1
"40049",1,0,0,0,0,0.784583331571564,1
"40050",1,0,0,0,0,0.784583331571564,1
"40051",1,0,0,0,0,0.784583331571564,1
"40052",1,0,0,0,0,0.784583331571564,1
"40053",1,0,0,0,0,0.784583331571564,1
"40054",1,0,0,0,0,0.784583331571564,1
"40055",1,0,0,0,0,0.784583331571564,1
"40056",1,0,0,0,0,0.784583331571564,1
"40057",1,0,0,0,0,0.784583331571564,1
"40058",1,0,0,0,0,0.784583331571564,1
"40059",1,0,0,0,0,0.784583331571564,1
"40060",1,0,0,0,0,0.784583331571564,1
"40061",1,0,0,0,0,0.784583331571564,1
"40062",1,0,0,0,0,0.784583331571564,1
"40063",1,0,0,0,0,0.784583331571564,1
"40064",1,0,0,0,0,0.784583331571564,1
"40065",1,0,0,0,0,0.784583331571564,1
"40066",1,0,0,0,0,0.784583331571564,1
"40067",1,0,0,0,0,0.784583331571564,1
"40068",1,0,0,0,0,0.784583331571564,1
"40069",1,0,0,0,0,0.784583331571564,1
"40070",1,0,0,0,0,0.784583331571564,1
"40071",1,0,0,0,0,0.784583331571564,1
"40072",1,0,0,0,0,0.784583331571564,1
"40073",1,0,0,0,0,0.784583331571564,1
"40074",1,0,0,0,0,0.784583331571564,1
"40075",1,0,0,0,0,0.784583331571564,1
"40076",1,0,0,0,0,0.784583331571564,1
"40077",1,0,0,0,0,0.784583331571564,1
"40078",1,0,0,0,0,0.784583331571564,1
"40079",1,0,0,0,0,0.784583331571564,1
"40080",1,0,0,0,0,0.784583331571564,1
"40081",1,0,0,0,0,0.784583331571564,1
"40082",1,0,0,0,0,0.784583331571564,1
"40083",1,0,0,0,0,0.784583331571564,1
"40084",1,0,0,0,0,0.784583331571564,1
"40085",1,0,0,0,0,0.784583331571564,1
"40086",1,0,0,0,0,0.784583331571564,1
"40087",1,0,0,0,0,0.784583331571564,1
"40088",1,0,0,0,0,0.784583331571564,1
"40089",1,0,0,0,0,0.784583331571564,1
"40090",1,0,0,0,0,0.784583331571564,1
"40091",1,0,0,0,0,0.784583331571564,1
"40092",1,0,0,0,0,0.784583331571564,1
"40093",1,0,0,0,0,0.784583331571564,1
"40094",1,0,0,0,0,0.784583331571564,1
"40095",1,0,0,0,0,0.784583331571564,1
"40096",1,0,0,0,0,0.784583331571564,1
"40097",1,0,0,0,0,0.784583331571564,1
"40098",1,0,0,0,0,0.784583331571564,1
"40099",1,0,0,0,0,0.784583331571564,1
"40100",1,0,0,0,0,0.784583331571564,1
"40101",1,0,0,0,0,0.784583331571564,1
"40102",1,0,0,0,0,0.784583331571564,1
"40103",1,0,0,0,0,0.784583331571564,1
"40104",1,0,0,0,0,0.784583331571564,1
"40105",1,0,0,0,0,0.784583331571564,1
"40106",1,0,0,0,0,0.784583331571564,1
"40107",1,0,0,0,0,0.784583331571564,1
"40108",1,0,0,0,0,0.784583331571564,1
"40109",1,0,0,0,0,0.784583331571564,1
"40110",1,0,0,0,0,0.784583331571564,1
"40111",1,0,0,0,0,0.784583331571564,1
"40112",1,0,0,0,0,0.784583331571564,1
"40113",1,0,0,0,0,0.784583331571564,1
"40114",1,0,0,0,0,0.784583331571564,1
"40115",1,0,0,0,0,0.784583331571564,1
"40116",1,0,0,0,0,0.784583331571564,1
"40117",1,0,0,0,0,0.784583331571564,1
"40118",1,0,0,0,0,0.784583331571564,1
"40119",1,0,0,0,0,0.784583331571564,1
"40120",1,0,0,0,0,0.784583331571564,1
"40121",1,0,0,0,0,0.784583331571564,1
"40122",1,0,0,0,0,0.784583331571564,1
"40123",1,0,0,0,0,0.784583331571564,1
"40124",1,0,0,0,0,0.784583331571564,1
"40125",1,0,0,0,0,0.784583331571564,1
"40126",1,0,0,0,0,0.784583331571564,1
"40127",1,0,0,0,0,0.784583331571564,1
"40128",1,0,0,0,0,0.784583331571564,1
"40129",1,0,0,0,0,0.784583331571564,1
"40130",1,0,0,0,0,0.784583331571564,1
"40131",1,0,0,0,0,0.784583331571564,1
"40132",1,0,0,0,0,0.784583331571564,1
"40133",1,0,0,0,0,0.784583331571564,1
"40134",1,0,0,0,0,0.784583331571564,1
"40135",1,0,0,0,0,0.784583331571564,1
"40136",1,0,0,0,0,0.784583331571564,1
"40137",1,0,0,0,0,0.784583331571564,1
"40138",1,0,0,0,0,0.784583331571564,1
"40139",1,0,0,0,0,0.784583331571564,1
"40140",1,0,0,0,0,0.784583331571564,1
"40141",1,0,0,0,0,0.784583331571564,1
"40142",1,0,0,0,0,0.784583331571564,1
"40143",1,0,0,0,0,0.784583331571564,1
"40144",1,0,0,0,0,0.784583331571564,1
"40145",1,0,0,0,0,0.784583331571564,1
"40146",1,0,0,0,0,0.784583331571564,1
"40147",1,0,0,0,0,0.784583331571564,1
"40148",1,0,0,0,0,0.784583331571564,1
"40149",1,0,0,0,0,0.784583331571564,1
"40150",1,0,0,0,0,0.784583331571564,1
"40151",1,0,0,0,0,0.784583331571564,1
"40152",1,0,0,0,0,0.784583331571564,1
"40153",1,0,0,0,0,0.784583331571564,1
"40154",1,0,0,0,0,0.784583331571564,1
"40155",1,0,0,0,0,0.784583331571564,1
"40156",1,0,0,0,0,0.784583331571564,1
"40157",1,0,0,0,0,0.784583331571564,1
"40158",1,0,0,0,0,0.784583331571564,1
"40159",1,0,0,0,0,0.784583331571564,1
"40160",1,0,0,0,0,0.784583331571564,1
"40161",1,0,0,0,0,0.784583331571564,1
"40162",1,0,0,0,0,0.784583331571564,1
"40163",1,0,0,0,0,0.784583331571564,1
"40164",1,0,0,0,0,0.784583331571564,1
"40165",1,0,0,0,0,0.784583331571564,1
"40166",1,0,0,0,0,0.784583331571564,1
"40167",1,0,0,0,0,0.784583331571564,1
"40168",1,0,0,0,0,0.784583331571564,1
"40169",1,0,0,0,0,0.784583331571564,1
"40170",1,0,0,0,0,0.784583331571564,1
"40171",1,0,0,0,0,0.784583331571564,1
"40172",1,0,0,0,0,0.784583331571564,1
"40173",1,0,0,0,0,0.784583331571564,1
"40174",1,0,0,0,0,0.784583331571564,1
"40175",1,0,0,0,0,0.784583331571564,1
"40176",1,0,0,0,0,0.784583331571564,1
"40177",1,0,0,0,0,0.784583331571564,1
"40178",1,0,0,0,0,0.784583331571564,1
"40179",1,0,0,0,0,0.784583331571564,1
"40180",1,0,0,0,0,0.784583331571564,1
"40181",1,0,0,0,0,0.784583331571564,1
"40182",1,0,0,0,0,0.784583331571564,1
"40183",1,0,0,0,0,0.784583331571564,1
"40184",1,0,0,0,0,0.784583331571564,1
"40185",1,0,0,0,0,0.784583331571564,1
"40186",1,0,0,0,0,0.784583331571564,1
"40187",1,0,0,0,0,0.784583331571564,1
"40188",1,0,0,0,0,0.784583331571564,1
"40189",1,0,0,0,0,0.784583331571564,1
"40190",1,0,0,0,0,0.784583331571564,1
"40191",1,0,0,0,0,0.784583331571564,1
"40192",1,0,0,0,0,0.784583331571564,1
"40193",1,0,0,0,0,0.784583331571564,1
"40194",1,0,0,0,0,0.784583331571564,1
"40195",1,0,0,0,0,0.784583331571564,1
"40196",1,0,0,0,0,0.784583331571564,1
"40197",1,0,0,0,0,0.784583331571564,1
"40198",1,0,0,0,0,0.784583331571564,1
"40199",1,0,0,0,0,0.784583331571564,1
"40200",1,0,0,0,0,0.784583331571564,1
"40201",1,0,0,0,0,0.784583331571564,1
"40202",1,0,0,0,0,0.784583331571564,1
"40203",1,0,0,0,0,0.784583331571564,1
"40204",1,0,0,0,0,0.784583331571564,1
"40205",1,0,0,0,0,0.784583331571564,1
"40206",1,0,0,0,0,0.784583331571564,1
"40207",1,0,0,0,0,0.784583331571564,1
"40208",1,0,0,0,0,0.784583331571564,1
"40209",1,0,0,0,0,0.784583331571564,1
"40210",1,0,0,0,0,0.784583331571564,1
"40211",1,0,0,0,0,0.784583331571564,1
"40212",1,0,0,0,0,0.784583331571564,1
"40213",1,0,0,0,0,0.784583331571564,1
"40214",1,0,0,0,0,0.784583331571564,1
"40215",1,0,0,0,0,0.784583331571564,1
"40216",1,0,0,0,0,0.784583331571564,1
"40217",1,0,0,0,0,0.784583331571564,1
"40218",1,0,0,0,0,0.784583331571564,1
"40219",1,0,0,0,0,0.784583331571564,1
"40220",1,0,0,0,0,0.784583331571564,1
"40221",1,0,0,0,0,0.784583331571564,1
"40222",1,0,0,0,0,0.784583331571564,1
"40223",1,0,0,0,0,0.784583331571564,1
"40224",1,0,0,0,0,0.784583331571564,1
"40225",1,0,0,0,0,0.784583331571564,1
"40226",1,0,0,0,0,0.784583331571564,1
"40227",1,0,0,0,0,0.784583331571564,1
"40228",1,0,0,0,0,0.784583331571564,1
"40229",1,0,0,0,0,0.784583331571564,1
"40230",1,0,0,0,0,0.784583331571564,1
"40231",1,0,0,0,0,0.784583331571564,1
"40232",1,0,0,0,0,0.784583331571564,1
"40233",1,0,0,0,0,0.784583331571564,1
"40234",1,0,0,0,0,0.784583331571564,1
"40235",1,0,0,0,0,0.784583331571564,1
"40236",1,0,0,0,0,0.784583331571564,1
"40237",1,0,0,0,0,0.784583331571564,1
"40238",1,0,0,0,0,0.784583331571564,1
"40239",1,0,0,0,0,0.784583331571564,1
"40240",1,0,0,0,0,0.784583331571564,1
"40241",1,0,0,0,0,0.784583331571564,1
"40242",1,0,0,0,0,0.784583331571564,1
"40243",1,0,0,0,0,0.784583331571564,1
"40244",1,0,0,0,0,0.784583331571564,1
"40245",1,0,0,0,0,0.784583331571564,1
"40246",1,0,0,0,0,0.784583331571564,1
"40247",1,0,0,0,0,0.784583331571564,1
"40248",1,0,0,0,0,0.784583331571564,1
"40249",1,0,0,0,0,0.784583331571564,1
"40250",1,0,0,0,0,0.784583331571564,1
"40251",1,0,0,0,0,0.784583331571564,1
"40252",1,0,0,0,0,0.784583331571564,1
"40253",1,0,0,0,0,0.784583331571564,1
"40254",1,0,0,0,0,0.784583331571564,1
"40255",1,0,0,0,0,0.784583331571564,1
"40256",1,0,0,0,0,0.784583331571564,1
"40257",1,0,0,0,0,0.784583331571564,1
"40258",1,0,0,0,0,0.784583331571564,1
"40259",1,0,0,0,0,0.784583331571564,1
"40260",1,0,0,0,0,0.784583331571564,1
"40261",1,0,0,0,0,0.784583331571564,1
"40262",1,0,0,0,0,0.784583331571564,1
"40263",1,0,0,0,0,0.784583331571564,1
"40264",1,0,0,0,0,0.784583331571564,1
"40265",1,0,0,0,0,0.784583331571564,1
"40266",1,0,0,0,0,0.784583331571564,1
"40267",1,0,0,0,0,0.784583331571564,1
"40268",1,0,0,0,0,0.784583331571564,1
"40269",1,0,0,0,0,0.784583331571564,1
"40270",1,0,0,0,0,0.784583331571564,1
"40271",1,0,0,0,0,0.784583331571564,1
"40272",1,0,0,0,0,0.784583331571564,1
"40273",1,0,0,0,0,0.784583331571564,1
"40274",1,0,0,0,0,0.784583331571564,1
"40275",1,0,0,0,0,0.784583331571564,1
"40276",1,0,0,0,0,0.784583331571564,1
"40277",1,0,0,0,0,0.784583331571564,1
"40278",1,0,0,0,0,0.784583331571564,1
"40279",1,0,0,0,0,0.784583331571564,1
"40280",1,0,0,0,0,0.784583331571564,1
"40281",1,0,0,0,0,0.784583331571564,1
"40282",1,0,0,0,0,0.784583331571564,1
"40283",1,0,0,0,0,0.784583331571564,1
"40284",1,0,0,0,0,0.784583331571564,1
"40285",1,0,0,0,0,0.784583331571564,1
"40286",1,0,0,0,0,0.784583331571564,1
"40287",1,0,0,0,0,0.784583331571564,1
"40288",1,0,0,0,0,0.784583331571564,1
"40289",1,0,0,0,0,0.784583331571564,1
"40290",1,0,0,0,0,0.784583331571564,1
"40291",1,0,0,0,0,0.784583331571564,1
"40292",1,0,0,0,0,0.784583331571564,1
"40293",1,0,0,0,0,0.784583331571564,1
"40294",1,0,0,0,0,0.784583331571564,1
"40295",1,0,0,0,0,0.784583331571564,1
"40296",1,0,0,0,0,0.784583331571564,1
"40297",1,0,0,0,0,0.784583331571564,1
"40298",1,0,0,0,0,0.784583331571564,1
"40299",1,0,0,0,0,0.784583331571564,1
"40300",1,0,0,0,0,0.784583331571564,1
"40301",1,0,0,0,0,0.784583331571564,1
"40302",1,0,0,0,0,0.784583331571564,1
"40303",1,0,0,0,0,0.784583331571564,1
"40304",1,0,0,0,0,0.784583331571564,1
"40305",1,0,0,0,0,0.784583331571564,1
"40306",1,0,0,0,0,0.784583331571564,1
"40307",1,0,0,0,0,0.784583331571564,1
"40308",1,0,0,0,0,0.784583331571564,1
"40309",1,0,0,0,0,0.784583331571564,1
"40310",1,0,0,0,0,0.784583331571564,1
"40311",1,0,0,0,0,0.784583331571564,1
"40312",1,0,0,0,0,0.784583331571564,1
"40313",1,0,0,0,0,0.784583331571564,1
"40314",1,0,0,0,0,0.784583331571564,1
"40315",1,0,0,0,0,0.784583331571564,1
"40316",1,0,0,0,0,0.784583331571564,1
"40317",1,0,0,0,0,0.784583331571564,1
"40318",1,0,0,0,0,0.784583331571564,1
"40319",1,0,0,0,0,0.784583331571564,1
"40320",1,0,0,0,0,0.784583331571564,1
"40321",1,0,0,0,0,0.784583331571564,1
"40322",1,0,0,0,0,0.784583331571564,1
"40323",1,0,0,0,0,0.784583331571564,1
"40324",1,0,0,0,0,0.784583331571564,1
"40325",1,0,0,0,0,0.784583331571564,1
"40326",1,0,0,0,0,0.784583331571564,1
"40327",1,0,0,0,0,0.784583331571564,1
"40328",1,0,0,0,0,0.784583331571564,1
"40329",1,0,0,0,0,0.784583331571564,1
"40330",1,0,0,0,0,0.784583331571564,1
"40331",1,0,0,0,0,0.784583331571564,1
"40332",1,0,0,0,0,0.784583331571564,1
"40333",1,0,0,0,0,0.784583331571564,1
"40334",1,0,0,0,0,0.784583331571564,1
"40335",1,0,0,0,0,0.784583331571564,1
"40336",1,0,0,0,0,0.784583331571564,1
"40337",1,0,0,0,0,0.784583331571564,1
"40338",1,0,0,0,0,0.784583331571564,1
"40339",1,0,0,0,0,0.784583331571564,1
"40340",1,0,0,0,0,0.784583331571564,1
"40341",1,0,0,0,0,0.784583331571564,1
"40342",1,0,0,0,0,0.784583331571564,1
"40343",1,0,0,0,0,0.784583331571564,1
"40344",1,0,0,0,0,0.784583331571564,1
"40345",1,0,0,0,0,0.784583331571564,1
"40346",1,0,0,0,0,0.784583331571564,1
"40347",1,0,0,0,0,0.784583331571564,1
"40348",1,0,0,0,0,0.784583331571564,1
"40349",1,0,0,0,0,0.784583331571564,1
"40350",1,0,0,0,0,0.784583331571564,1
"40351",1,0,0,0,0,0.784583331571564,1
"40352",1,0,0,0,0,0.784583331571564,1
"40353",1,0,0,0,0,0.784583331571564,1
"40354",1,0,0,0,0,0.784583331571564,1
"40355",1,0,0,0,0,0.784583331571564,1
"40356",1,0,0,0,0,0.784583331571564,1
"40357",1,0,0,0,0,0.784583331571564,1
"40358",1,0,0,0,0,0.784583331571564,1
"40359",1,0,0,0,0,0.784583331571564,1
"40360",1,0,0,0,0,0.784583331571564,1
"40361",1,0,0,0,0,0.784583331571564,1
"40362",1,0,0,0,0,0.784583331571564,1
"40363",1,0,0,0,0,0.784583331571564,1
"40364",1,0,0,0,0,0.784583331571564,1
"40365",1,0,0,0,0,0.784583331571564,1
"40366",1,0,0,0,0,0.784583331571564,1
"40367",1,0,0,0,0,0.784583331571564,1
"40368",1,0,0,0,0,0.784583331571564,1
"40369",1,0,0,0,0,0.784583331571564,1
"40370",1,0,0,0,0,0.784583331571564,1
"40371",1,0,0,0,0,0.784583331571564,1
"40372",1,0,0,0,0,0.784583331571564,1
"40373",1,0,0,0,0,0.784583331571564,1
"40374",1,0,0,0,0,0.784583331571564,1
"40375",1,0,0,0,0,0.784583331571564,1
"40376",1,0,0,0,0,0.784583331571564,1
"40377",1,0,0,0,0,0.784583331571564,1
"40378",1,0,0,0,0,0.784583331571564,1
"40379",1,0,0,0,0,0.784583331571564,1
"40380",1,0,0,0,0,0.784583331571564,1
"40381",1,0,0,0,0,0.784583331571564,1
"40382",1,0,0,0,0,0.784583331571564,1
"40383",1,0,0,0,0,0.784583331571564,1
"40384",1,0,0,0,0,0.784583331571564,1
"40385",1,0,0,0,0,0.784583331571564,1
"40386",1,0,0,0,0,0.784583331571564,1
"40387",1,0,0,0,0,0.784583331571564,1
"40388",1,0,0,0,0,0.784583331571564,1
"40389",1,0,0,0,0,0.784583331571564,1
"40390",1,0,0,0,0,0.784583331571564,1
"40391",1,0,0,0,0,0.784583331571564,1
"40392",1,0,0,0,0,0.784583331571564,1
"40393",1,0,0,0,0,0.784583331571564,1
"40394",1,0,0,0,0,0.784583331571564,1
"40395",1,0,0,0,0,0.784583331571564,1
"40396",1,0,0,0,0,0.784583331571564,1
"40397",1,0,0,0,0,0.784583331571564,1
"40398",1,0,0,0,0,0.784583331571564,1
"40399",1,0,0,0,0,0.784583331571564,1
"40400",1,0,0,0,0,0.784583331571564,1
"40401",1,0,0,0,0,0.784583331571564,1
"40402",1,0,0,0,0,0.784583331571564,1
"40403",1,0,0,0,0,0.784583331571564,1
"40404",1,0,0,0,0,0.784583331571564,1
"40405",1,0,0,0,0,0.784583331571564,1
"40406",1,0,0,0,0,0.784583331571564,1
"40407",1,0,0,0,0,0.784583331571564,1
"40408",1,0,0,0,0,0.784583331571564,1
"40409",1,0,0,0,0,0.784583331571564,1
"40410",1,0,0,0,0,0.784583331571564,1
"40411",1,0,0,0,0,0.784583331571564,1
"40412",1,0,0,0,0,0.784583331571564,1
"40413",1,0,0,0,0,0.784583331571564,1
"40414",1,0,0,0,0,0.784583331571564,1
"40415",1,0,0,0,0,0.784583331571564,1
"40416",1,0,0,0,0,0.784583331571564,1
"40417",1,0,0,0,0,0.784583331571564,1
"40418",1,0,0,0,0,0.784583331571564,1
"40419",1,0,0,0,0,0.784583331571564,1
"40420",1,0,0,0,0,0.784583331571564,1
"40421",1,0,0,0,0,0.784583331571564,1
"40422",1,0,0,0,0,0.784583331571564,1
"40423",1,0,0,0,0,0.784583331571564,1
"40424",1,0,0,0,0,0.784583331571564,1
"40425",1,0,0,0,0,0.784583331571564,1
"40426",1,0,0,0,0,0.784583331571564,1
"40427",1,0,0,0,0,0.784583331571564,1
"40428",1,0,0,0,0,0.784583331571564,1
"40429",1,0,0,0,0,0.784583331571564,1
"40430",1,0,0,0,0,0.784583331571564,1
"40431",1,0,0,0,0,0.784583331571564,1
"40432",1,0,0,0,0,0.784583331571564,1
"40433",1,0,0,0,0,0.784583331571564,1
"40434",1,0,0,0,0,0.784583331571564,1
"40435",1,0,0,0,0,0.784583331571564,1
"40436",1,0,0,0,0,0.784583331571564,1
"40437",1,0,0,0,0,0.784583331571564,1
"40438",1,0,0,0,0,0.784583331571564,1
"40439",1,0,0,0,0,0.784583331571564,1
"40440",1,0,0,0,0,0.784583331571564,1
"40441",1,0,0,0,0,0.784583331571564,1
"40442",1,0,0,0,0,0.784583331571564,1
"40443",1,0,0,0,0,0.784583331571564,1
"40444",1,0,0,0,0,0.784583331571564,1
"40445",1,0,0,0,0,0.784583331571564,1
"40446",1,0,0,0,0,0.784583331571564,1
"40447",1,0,0,0,0,0.784583331571564,1
"40448",1,0,0,0,0,0.784583331571564,1
"40449",1,0,0,0,0,0.784583331571564,1
"40450",1,0,0,0,0,0.784583331571564,1
"40451",1,0,0,0,0,0.784583331571564,1
"40452",1,0,0,0,0,0.784583331571564,1
"40453",1,0,0,0,0,0.784583331571564,1
"40454",1,0,0,0,0,0.784583331571564,1
"40455",1,0,0,0,0,0.784583331571564,1
"40456",1,0,0,0,0,0.784583331571564,1
"40457",1,0,0,0,0,0.784583331571564,1
"40458",1,0,0,0,0,0.784583331571564,1
"40459",1,0,0,0,0,0.784583331571564,1
"40460",1,0,0,0,0,0.784583331571564,1
"40461",1,0,0,0,0,0.784583331571564,1
"40462",1,0,0,0,0,0.784583331571564,1
"40463",1,0,0,0,0,0.784583331571564,1
"40464",1,0,0,0,0,0.784583331571564,1
"40465",1,0,0,0,0,0.784583331571564,1
"40466",1,0,0,0,0,0.784583331571564,1
"40467",1,0,0,0,0,0.784583331571564,1
"40468",1,0,0,0,0,0.784583331571564,1
"40469",1,0,0,0,0,0.784583331571564,1
"40470",1,0,0,0,0,0.784583331571564,1
"40471",1,0,0,0,0,0.784583331571564,1
"40472",1,0,0,0,0,0.784583331571564,1
"40473",1,0,0,0,0,0.784583331571564,1
"40474",1,0,0,0,0,0.784583331571564,1
"40475",1,0,0,0,0,0.784583331571564,1
"40476",1,0,0,0,0,0.784583331571564,1
"40477",1,0,0,0,0,0.784583331571564,1
"40478",1,0,0,0,0,0.784583331571564,1
"40479",1,0,0,0,0,0.784583331571564,1
"40480",1,0,0,0,0,0.784583331571564,1
"40481",1,0,0,0,0,0.784583331571564,1
"40482",1,0,0,0,0,0.784583331571564,1
"40483",1,0,0,0,0,0.784583331571564,1
"40484",1,0,0,0,0,0.784583331571564,1
"40485",1,0,0,0,0,0.784583331571564,1
"40486",1,0,0,0,0,0.784583331571564,1
"40487",1,0,0,0,0,0.784583331571564,1
"40488",1,0,0,0,0,0.784583331571564,1
"40489",1,0,0,0,0,0.784583331571564,1
"40490",1,0,0,0,0,0.784583331571564,1
"40491",1,0,0,0,0,0.784583331571564,1
"40492",1,0,0,0,0,0.784583331571564,1
"40493",1,0,0,0,0,0.784583331571564,1
"40494",1,0,0,0,0,0.784583331571564,1
"40495",1,0,0,0,0,0.784583331571564,1
"40496",1,0,0,0,0,0.784583331571564,1
"40497",1,0,0,0,0,0.784583331571564,1
"40498",1,0,0,0,0,0.784583331571564,1
"40499",1,0,0,0,0,0.784583331571564,1
"40500",1,0,0,0,0,0.784583331571564,1
"40501",1,0,0,0,0,0.784583331571564,1
"40502",1,0,0,0,0,0.784583331571564,1
"40503",1,0,0,0,0,0.784583331571564,1
"40504",1,0,0,0,0,0.784583331571564,1
"40505",1,0,0,0,0,0.784583331571564,1
"40506",1,0,0,0,0,0.784583331571564,1
"40507",1,0,0,0,0,0.784583331571564,1
"40508",1,0,0,0,0,0.784583331571564,1
"40509",1,0,0,0,0,0.784583331571564,1
"40510",1,0,0,0,0,0.784583331571564,1
"40511",1,0,0,0,0,0.784583331571564,1
"40512",1,0,0,0,0,0.784583331571564,1
"40513",1,0,0,0,0,0.784583331571564,1
"40514",1,0,0,0,0,0.784583331571564,1
"40515",1,0,0,0,0,0.784583331571564,1
"40516",1,0,0,0,0,0.784583331571564,1
"40517",1,0,0,0,0,0.784583331571564,1
"40518",1,0,0,0,0,0.784583331571564,1
"40519",1,0,0,0,0,0.784583331571564,1
"40520",1,0,0,0,0,0.784583331571564,1
"40521",1,0,0,0,0,0.784583331571564,1
"40522",1,0,0,0,0,0.784583331571564,1
"40523",1,0,0,0,0,0.784583331571564,1
"40524",1,0,0,0,0,0.784583331571564,1
"40525",1,0,0,0,0,0.784583331571564,1
"40526",1,0,0,0,0,0.784583331571564,1
"40527",1,0,0,0,0,0.784583331571564,1
"40528",1,0,0,0,0,0.784583331571564,1
"40529",1,0,0,0,0,0.784583331571564,1
"40530",1,0,0,0,0,0.784583331571564,1
"40531",1,0,0,0,0,0.784583331571564,1
"40532",1,0,0,0,0,0.784583331571564,1
"40533",1,0,0,0,0,0.784583331571564,1
"40534",1,0,0,0,0,0.784583331571564,1
"40535",1,0,0,0,0,0.784583331571564,1
"40536",1,0,0,0,0,0.784583331571564,1
"40537",1,0,0,0,0,0.784583331571564,1
"40538",1,0,0,0,0,0.784583331571564,1
"40539",1,0,0,0,0,0.784583331571564,1
"40540",1,0,0,0,0,0.784583331571564,1
"40541",1,0,0,0,0,0.784583331571564,1
"40542",1,0,0,0,0,0.784583331571564,1
"40543",1,0,0,0,0,0.784583331571564,1
"40544",1,0,0,0,0,0.784583331571564,1
"40545",1,0,0,0,0,0.784583331571564,1
"40546",1,0,0,0,0,0.784583331571564,1
"40547",1,0,0,0,0,0.784583331571564,1
"40548",1,0,0,0,0,0.784583331571564,1
"40549",1,0,0,0,0,0.784583331571564,1
"40550",1,0,0,0,0,0.784583331571564,1
"40551",1,0,0,0,0,0.784583331571564,1
"40552",1,0,0,0,0,0.784583331571564,1
"40553",1,0,0,0,0,0.784583331571564,1
"40554",1,0,0,0,0,0.784583331571564,1
"40555",1,0,0,0,0,0.784583331571564,1
"40556",1,0,0,0,0,0.784583331571564,1
"40557",1,0,0,0,0,0.784583331571564,1
"40558",1,0,0,0,0,0.784583331571564,1
"40559",1,0,0,0,0,0.784583331571564,1
"40560",1,0,0,0,0,0.784583331571564,1
"40561",1,0,0,0,0,0.784583331571564,1
"40562",1,0,0,0,0,0.784583331571564,1
"40563",1,0,0,0,0,0.784583331571564,1
"40564",1,0,0,0,0,0.784583331571564,1
"40565",1,0,0,0,0,0.784583331571564,1
"40566",1,0,0,0,0,0.784583331571564,1
"40567",1,0,0,0,0,0.784583331571564,1
"40568",1,0,0,0,0,0.784583331571564,1
"40569",1,0,0,0,0,0.784583331571564,1
"40570",1,0,0,0,0,0.784583331571564,1
"40571",1,0,0,0,0,0.784583331571564,1
"40572",1,0,0,0,0,0.784583331571564,1
"40573",1,0,0,0,0,0.784583331571564,1
"40574",1,0,0,0,0,0.784583331571564,1
"40575",1,0,0,0,0,0.784583331571564,1
"40576",1,0,0,0,0,0.784583331571564,1
"40577",1,0,0,0,0,0.784583331571564,1
"40578",1,0,0,0,0,0.784583331571564,1
"40579",1,0,0,0,0,0.784583331571564,1
"40580",1,0,0,0,0,0.784583331571564,1
"40581",1,0,0,0,0,0.784583331571564,1
"40582",1,0,0,0,0,0.784583331571564,1
"40583",1,0,0,0,0,0.784583331571564,1
"40584",1,0,0,0,0,0.784583331571564,1
"40585",1,0,0,0,0,0.784583331571564,1
"40586",1,0,0,0,0,0.784583331571564,1
"40587",1,0,0,0,0,0.784583331571564,1
"40588",1,0,0,0,0,0.784583331571564,1
"40589",1,0,0,0,0,0.784583331571564,1
"40590",1,0,0,0,0,0.784583331571564,1
"40591",1,0,0,0,0,0.784583331571564,1
"40592",1,0,0,0,0,0.784583331571564,1
"40593",1,0,0,0,0,0.784583331571564,1
"40594",1,0,0,0,0,0.784583331571564,1
"40595",1,0,0,0,0,0.784583331571564,1
"40596",1,0,0,0,0,0.784583331571564,1
"40597",1,0,0,0,0,0.784583331571564,1
"40598",1,0,0,0,0,0.784583331571564,1
"40599",1,0,0,0,0,0.784583331571564,1
"40600",1,0,0,0,0,0.784583331571564,1
"40601",1,0,0,0,0,0.784583331571564,1
"40602",1,0,0,0,0,0.784583331571564,1
"40603",1,0,0,0,0,0.784583331571564,1
"40604",1,0,0,0,0,0.784583331571564,1
"40605",1,0,0,0,0,0.784583331571564,1
"40606",1,0,0,0,0,0.784583331571564,1
"40607",1,0,0,0,0,0.784583331571564,1
"40608",1,0,0,0,0,0.784583331571564,1
"40609",1,0,0,0,0,0.784583331571564,1
"40610",1,0,0,0,0,0.784583331571564,1
"40611",1,0,0,0,0,0.784583331571564,1
"40612",1,0,0,0,0,0.784583331571564,1
"40613",1,0,0,0,0,0.784583331571564,1
"40614",1,0,0,0,0,0.784583331571564,1
"40615",1,0,0,0,0,0.784583331571564,1
"40616",1,0,0,0,0,0.784583331571564,1
"40617",1,0,0,0,0,0.784583331571564,1
"40618",1,0,0,0,0,0.784583331571564,1
"40619",1,0,0,0,0,0.784583331571564,1
"40620",1,0,0,0,0,0.784583331571564,1
"40621",1,0,0,0,0,0.784583331571564,1
"40622",1,0,0,0,0,0.784583331571564,1
"40623",1,0,0,0,0,0.784583331571564,1
"40624",1,0,0,0,0,0.784583331571564,1
"40625",1,0,0,0,0,0.784583331571564,1
"40626",1,0,0,0,0,0.784583331571564,1
"40627",1,0,0,0,0,0.784583331571564,1
"40628",1,0,0,0,0,0.784583331571564,1
"40629",1,0,0,0,0,0.784583331571564,1
"40630",1,0,0,0,0,0.784583331571564,1
"40631",1,0,0,0,0,0.784583331571564,1
"40632",1,0,0,0,0,0.784583331571564,1
"40633",1,0,0,0,0,0.784583331571564,1
"40634",1,0,0,0,0,0.784583331571564,1
"40635",1,0,0,0,0,0.784583331571564,1
"40636",1,0,0,0,0,0.784583331571564,1
"40637",1,0,0,0,0,0.784583331571564,1
"40638",1,0,0,0,0,0.784583331571564,1
"40639",1,0,0,0,0,0.784583331571564,1
"40640",1,0,0,0,0,0.784583331571564,1
"40641",1,0,0,0,0,0.784583331571564,1
"40642",1,0,0,0,0,0.784583331571564,1
"40643",1,0,0,0,0,0.784583331571564,1
"40644",1,0,0,0,0,0.784583331571564,1
"40645",1,0,0,0,0,0.784583331571564,1
"40646",1,0,0,0,0,0.784583331571564,1
"40647",1,0,0,0,0,0.784583331571564,1
"40648",1,0,0,0,0,0.784583331571564,1
"40649",1,0,0,0,0,0.784583331571564,1
"40650",1,0,0,0,0,0.784583331571564,1
"40651",1,0,0,0,0,0.784583331571564,1
"40652",1,0,0,0,0,0.784583331571564,1
"40653",1,0,0,0,0,0.784583331571564,1
"40654",1,0,0,0,0,0.784583331571564,1
"40655",1,0,0,0,0,0.784583331571564,1
"40656",1,0,0,0,0,0.784583331571564,1
"40657",1,0,0,0,0,0.784583331571564,1
"40658",1,0,0,0,0,0.784583331571564,1
"40659",1,0,0,0,0,0.784583331571564,1
"40660",1,0,0,0,0,0.784583331571564,1
"40661",1,0,0,0,0,0.784583331571564,1
"40662",1,0,0,0,0,0.784583331571564,1
"40663",1,0,0,0,0,0.784583331571564,1
"40664",1,0,0,0,0,0.784583331571564,1
"40665",1,0,0,0,0,0.784583331571564,1
"40666",1,0,0,0,0,0.784583331571564,1
"40667",1,0,0,0,0,0.784583331571564,1
"40668",1,0,0,0,0,0.784583331571564,1
"40669",1,0,0,0,0,0.784583331571564,1
"40670",1,0,0,0,0,0.784583331571564,1
"40671",1,0,0,0,0,0.784583331571564,1
"40672",1,0,0,0,0,0.784583331571564,1
"40673",1,0,0,0,0,0.784583331571564,1
"40674",1,0,0,0,0,0.784583331571564,1
"40675",1,0,0,0,0,0.784583331571564,1
"40676",1,0,0,0,0,0.784583331571564,1
"40677",1,0,0,0,0,0.784583331571564,1
"40678",1,0,0,0,0,0.784583331571564,1
"40679",1,0,0,0,0,0.784583331571564,1
"40680",1,0,0,0,0,0.784583331571564,1
"40681",1,0,0,0,0,0.784583331571564,1
"40682",1,0,0,0,0,0.784583331571564,1
"40683",1,0,0,0,0,0.784583331571564,1
"40684",1,0,0,0,0,0.784583331571564,1
"40685",1,0,0,0,0,0.784583331571564,1
"40686",1,0,0,0,0,0.784583331571564,1
"40687",1,0,0,0,0,0.784583331571564,1
"40688",1,0,0,0,0,0.784583331571564,1
"40689",1,0,0,0,0,0.784583331571564,1
"40690",1,0,0,0,0,0.784583331571564,1
"40691",1,0,0,0,0,0.784583331571564,1
"40692",1,0,0,0,0,0.784583331571564,1
"40693",1,0,0,0,0,0.784583331571564,1
"40694",1,0,0,0,0,0.784583331571564,1
"40695",1,0,0,0,0,0.784583331571564,1
"40696",1,0,0,0,0,0.784583331571564,1
"40697",1,0,0,0,0,0.784583331571564,1
"40698",1,0,0,0,0,0.784583331571564,1
"40699",1,0,0,0,0,0.784583331571564,1
"40700",1,0,0,0,0,0.784583331571564,1
"40701",1,0,0,0,0,0.784583331571564,1
"40702",1,0,0,0,0,0.784583331571564,1
"40703",1,0,0,0,0,0.784583331571564,1
"40704",1,0,0,0,0,0.784583331571564,1
"40705",1,0,0,0,0,0.784583331571564,1
"40706",1,0,0,0,0,0.784583331571564,1
"40707",1,0,0,0,0,0.784583331571564,1
"40708",1,0,0,0,0,0.784583331571564,1
"40709",1,0,0,0,0,0.784583331571564,1
"40710",1,0,0,0,0,0.784583331571564,1
"40711",1,0,0,0,0,0.784583331571564,1
"40712",1,0,0,0,0,0.784583331571564,1
"40713",1,0,0,0,0,0.784583331571564,1
"40714",1,0,0,0,0,0.784583331571564,1
"40715",1,0,0,0,0,0.784583331571564,1
"40716",1,0,0,0,0,0.784583331571564,1
"40717",1,0,0,0,0,0.784583331571564,1
"40718",1,0,0,0,0,0.784583331571564,1
"40719",1,0,0,0,0,0.784583331571564,1
"40720",1,0,0,0,0,0.784583331571564,1
"40721",1,0,0,0,0,0.784583331571564,1
"40722",1,0,0,0,0,0.784583331571564,1
"40723",1,0,0,0,0,0.784583331571564,1
"40724",1,0,0,0,0,0.784583331571564,1
"40725",1,0,0,0,0,0.784583331571564,1
"40726",1,0,0,0,0,0.784583331571564,1
"40727",1,0,0,0,0,0.784583331571564,1
"40728",1,0,0,0,0,0.784583331571564,1
"40729",1,0,0,0,0,0.784583331571564,1
"40730",1,0,0,0,0,0.784583331571564,1
"40731",1,0,0,0,0,0.784583331571564,1
"40732",1,0,0,0,0,0.784583331571564,1
"40733",1,0,0,0,0,0.784583331571564,1
"40734",1,0,0,0,0,0.784583331571564,1
"40735",1,0,0,0,0,0.784583331571564,1
"40736",1,0,0,0,0,0.784583331571564,1
"40737",1,0,0,0,0,0.784583331571564,1
"40738",1,0,0,0,0,0.784583331571564,1
"40739",1,0,0,0,0,0.784583331571564,1
"40740",1,0,0,0,0,0.784583331571564,1
"40741",1,0,0,0,0,0.784583331571564,1
"40742",1,0,0,0,0,0.784583331571564,1
"40743",1,0,0,0,0,0.784583331571564,1
"40744",1,0,0,0,0,0.784583331571564,1
"40745",1,0,0,0,0,0.784583331571564,1
"40746",1,0,0,0,0,0.784583331571564,1
"40747",1,0,0,0,0,0.784583331571564,1
"40748",1,0,0,0,0,0.784583331571564,1
"40749",1,0,0,0,0,0.784583331571564,1
"40750",1,0,0,0,0,0.784583331571564,1
"40751",1,0,0,0,0,0.784583331571564,1
"40752",1,0,0,0,0,0.784583331571564,1
"40753",1,0,0,0,0,0.784583331571564,1
"40754",1,0,0,0,0,0.784583331571564,1
"40755",1,0,0,0,0,0.784583331571564,1
"40756",1,0,0,0,0,0.784583331571564,1
"40757",1,0,0,0,0,0.784583331571564,1
"40758",1,0,0,0,0,0.784583331571564,1
"40759",1,0,0,0,0,0.784583331571564,1
"40760",1,0,0,0,0,0.784583331571564,1
"40761",1,0,0,0,0,0.784583331571564,1
"40762",1,0,0,0,0,0.784583331571564,1
"40763",1,0,0,0,0,0.784583331571564,1
"40764",1,0,0,0,0,0.784583331571564,1
"40765",1,0,0,0,0,0.784583331571564,1
"40766",1,0,0,0,0,0.784583331571564,1
"40767",1,0,0,0,0,0.784583331571564,1
"40768",1,0,0,0,0,0.784583331571564,1
"40769",1,0,0,0,0,0.784583331571564,1
"40770",1,0,0,0,0,0.784583331571564,1
"40771",1,0,0,0,0,0.784583331571564,1
"40772",1,0,0,0,0,0.784583331571564,1
"40773",1,0,0,0,0,0.784583331571564,1
"40774",1,0,0,0,0,0.784583331571564,1
"40775",1,0,0,0,0,0.784583331571564,1
"40776",1,0,0,0,0,0.784583331571564,1
"40777",1,0,0,0,0,0.784583331571564,1
"40778",1,0,0,0,0,0.784583331571564,1
"40779",1,0,0,0,0,0.784583331571564,1
"40780",1,0,0,0,0,0.784583331571564,1
"40781",1,0,0,0,0,0.784583331571564,1
"40782",1,0,0,0,0,0.784583331571564,1
"40783",1,0,0,0,0,0.784583331571564,1
"40784",1,0,0,0,0,0.784583331571564,1
"40785",1,0,0,0,0,0.784583331571564,1
"40786",1,0,0,0,0,0.784583331571564,1
"40787",1,0,0,0,0,0.784583331571564,1
"40788",1,0,0,0,0,0.784583331571564,1
"40789",1,0,0,0,0,0.784583331571564,1
"40790",1,0,0,0,0,0.784583331571564,1
"40791",1,0,0,0,0,0.784583331571564,1
"40792",1,0,0,0,0,0.784583331571564,1
"40793",1,0,0,0,0,0.784583331571564,1
"40794",1,0,0,0,0,0.784583331571564,1
"40795",1,0,0,0,0,0.784583331571564,1
"40796",1,0,0,0,0,0.784583331571564,1
"40797",1,0,0,0,0,0.784583331571564,1
"40798",1,0,0,0,0,0.784583331571564,1
"40799",1,0,0,0,0,0.784583331571564,1
"40800",1,0,0,0,0,0.784583331571564,1
"40801",1,0,0,0,0,0.784583331571564,1
"40802",1,0,0,0,0,0.784583331571564,1
"40803",1,0,0,0,0,0.784583331571564,1
"40804",1,0,0,0,0,0.784583331571564,1
"40805",1,0,0,0,0,0.784583331571564,1
"40806",1,0,0,0,0,0.784583331571564,1
"40807",1,0,0,0,0,0.784583331571564,1
"40808",1,0,0,0,0,0.784583331571564,1
"40809",1,0,0,0,0,0.784583331571564,1
"40810",1,0,0,0,0,0.784583331571564,1
"40811",1,0,0,0,0,0.784583331571564,1
"40812",1,0,0,0,0,0.784583331571564,1
"40813",1,0,0,0,0,0.784583331571564,1
"40814",1,0,0,0,0,0.784583331571564,1
"40815",1,0,0,0,0,0.784583331571564,1
"40816",1,0,0,0,0,0.784583331571564,1
"40817",1,0,0,0,0,0.784583331571564,1
"40818",1,0,0,0,0,0.784583331571564,1
"40819",1,0,0,0,0,0.784583331571564,1
"40820",1,0,0,0,0,0.784583331571564,1
"40821",1,0,0,0,0,0.784583331571564,1
"40822",1,0,0,0,0,0.784583331571564,1
"40823",1,0,0,0,0,0.784583331571564,1
"40824",1,0,0,0,0,0.784583331571564,1
"40825",1,0,0,0,0,0.784583331571564,1
"40826",1,0,0,0,0,0.784583331571564,1
"40827",1,0,0,0,0,0.784583331571564,1
"40828",1,0,0,0,0,0.784583331571564,1
"40829",1,0,0,0,0,0.784583331571564,1
"40830",1,0,0,0,0,0.784583331571564,1
"40831",1,0,0,0,0,0.784583331571564,1
"40832",1,0,0,0,0,0.784583331571564,1
"40833",1,0,0,0,0,0.784583331571564,1
"40834",1,0,0,0,0,0.784583331571564,1
"40835",1,0,0,0,0,0.784583331571564,1
"40836",1,0,0,0,0,0.784583331571564,1
"40837",1,0,0,0,0,0.784583331571564,1
"40838",1,0,0,0,0,0.784583331571564,1
"40839",1,0,0,0,0,0.784583331571564,1
"40840",1,0,0,0,0,0.784583331571564,1
"40841",1,0,0,0,0,0.784583331571564,1
"40842",1,0,0,0,0,0.784583331571564,1
"40843",1,0,0,0,0,0.784583331571564,1
"40844",1,0,0,0,0,0.784583331571564,1
"40845",1,0,0,0,0,0.784583331571564,1
"40846",1,0,0,0,0,0.784583331571564,1
"40847",1,0,0,0,0,0.784583331571564,1
"40848",1,0,0,0,0,0.784583331571564,1
"40849",1,0,0,0,0,0.784583331571564,1
"40850",1,0,0,0,0,0.784583331571564,1
"40851",1,0,0,0,0,0.784583331571564,1
"40852",1,0,0,0,0,0.784583331571564,1
"40853",1,0,0,0,0,0.784583331571564,1
"40854",1,0,0,0,0,0.784583331571564,1
"40855",1,0,0,0,0,0.784583331571564,1
"40856",1,0,0,0,0,0.784583331571564,1
"40857",1,0,0,0,0,0.784583331571564,1
"40858",1,0,0,0,0,0.784583331571564,1
"40859",1,0,0,0,0,0.784583331571564,1
"40860",1,0,0,0,0,0.784583331571564,1
"40861",1,0,0,0,0,0.784583331571564,1
"40862",1,0,0,0,0,0.784583331571564,1
"40863",1,0,0,0,0,0.784583331571564,1
"40864",1,0,0,0,0,0.784583331571564,1
"40865",1,0,0,0,0,0.784583331571564,1
"40866",1,0,0,0,0,0.784583331571564,1
"40867",1,0,0,0,0,0.784583331571564,1
"40868",1,0,0,0,0,0.784583331571564,1
"40869",1,0,0,0,0,0.784583331571564,1
"40870",1,0,0,0,0,0.784583331571564,1
"40871",1,0,0,0,0,0.784583331571564,1
"40872",1,0,0,0,0,0.784583331571564,1
"40873",1,0,0,0,0,0.784583331571564,1
"40874",1,0,0,0,0,0.784583331571564,1
"40875",1,0,0,0,0,0.784583331571564,1
"40876",1,0,0,0,0,0.784583331571564,1
"40877",1,0,0,0,0,0.784583331571564,1
"40878",1,0,0,0,0,0.784583331571564,1
"40879",1,0,0,0,0,0.784583331571564,1
"40880",1,0,0,0,0,0.784583331571564,1
"40881",1,0,0,0,0,0.784583331571564,1
"40882",1,0,0,0,0,0.784583331571564,1
"40883",1,0,0,0,0,0.784583331571564,1
"40884",1,0,0,0,0,0.784583331571564,1
"40885",1,0,0,0,0,0.784583331571564,1
"40886",1,0,0,0,0,0.784583331571564,1
"40887",1,0,0,0,0,0.784583331571564,1
"40888",1,0,0,0,0,0.784583331571564,1
"40889",1,0,0,0,0,0.784583331571564,1
"40890",1,0,0,0,0,0.784583331571564,1
"40891",1,0,0,0,0,0.784583331571564,1
"40892",1,0,0,0,0,0.784583331571564,1
"40893",1,0,0,0,0,0.784583331571564,1
"40894",1,0,0,0,0,0.784583331571564,1
"40895",1,0,0,0,0,0.784583331571564,1
"40896",1,0,0,0,0,0.784583331571564,1
"40897",1,0,0,0,0,0.784583331571564,1
"40898",1,0,0,0,0,0.784583331571564,1
"40899",1,0,0,0,0,0.784583331571564,1
"40900",1,0,0,0,0,0.784583331571564,1
"40901",1,0,0,0,0,0.784583331571564,1
"40902",1,0,0,0,0,0.784583331571564,1
"40903",1,0,0,0,0,0.784583331571564,1
"40904",1,0,0,0,0,0.784583331571564,1
"40905",1,0,0,0,0,0.784583331571564,1
"40906",1,0,0,0,0,0.784583331571564,1
"40907",1,0,0,0,0,0.784583331571564,1
"40908",1,0,0,0,0,0.784583331571564,1
"40909",1,0,0,0,0,0.784583331571564,1
"40910",1,0,0,0,0,0.784583331571564,1
"40911",1,0,0,0,0,0.784583331571564,1
"40912",1,0,0,0,0,0.784583331571564,1
"40913",1,0,0,0,0,0.784583331571564,1
"40914",1,0,0,0,0,0.784583331571564,1
"40915",1,0,0,0,0,0.784583331571564,1
"40916",1,0,0,0,0,0.784583331571564,1
"40917",1,0,0,0,0,0.784583331571564,1
"40918",1,0,0,0,0,0.784583331571564,1
"40919",1,0,0,0,0,0.784583331571564,1
"40920",1,0,0,0,0,0.784583331571564,1
"40921",1,0,0,0,0,0.784583331571564,1
"40922",1,0,0,0,0,0.784583331571564,1
"40923",1,0,0,0,0,0.784583331571564,1
"40924",1,0,0,0,0,0.784583331571564,1
"40925",1,0,0,0,0,0.784583331571564,1
"40926",1,0,0,0,0,0.784583331571564,1
"40927",1,0,0,0,0,0.784583331571564,1
"40928",1,0,0,0,0,0.784583331571564,1
"40929",1,0,0,0,0,0.784583331571564,1
"40930",1,0,0,0,0,0.784583331571564,1
"40931",1,0,0,0,0,0.784583331571564,1
"40932",1,0,0,0,0,0.784583331571564,1
"40933",1,0,0,0,0,0.784583331571564,1
"40934",1,0,0,0,0,0.784583331571564,1
"40935",1,0,0,0,0,0.784583331571564,1
"40936",1,0,0,0,0,0.784583331571564,1
"40937",1,0,0,0,0,0.784583331571564,1
"40938",1,0,0,0,0,0.784583331571564,1
"40939",1,0,0,0,0,0.784583331571564,1
"40940",1,0,0,0,0,0.784583331571564,1
"40941",1,0,0,0,0,0.784583331571564,1
"40942",1,0,0,0,0,0.784583331571564,1
"40943",1,0,0,0,0,0.784583331571564,1
"40944",1,0,0,0,0,0.784583331571564,1
"40945",1,0,0,0,0,0.784583331571564,1
"40946",1,0,0,0,0,0.784583331571564,1
"40947",1,0,0,0,0,0.784583331571564,1
"40948",1,0,0,0,0,0.784583331571564,1
"40949",1,0,0,0,0,0.784583331571564,1
"40950",1,0,0,0,0,0.784583331571564,1
"40951",1,0,0,0,0,0.784583331571564,1
"40952",1,0,0,0,0,0.784583331571564,1
"40953",1,0,0,0,0,0.784583331571564,1
"40954",1,0,0,0,0,0.784583331571564,1
"40955",1,0,0,0,0,0.784583331571564,1
"40956",1,0,0,0,0,0.784583331571564,1
"40957",1,0,0,0,0,0.784583331571564,1
"40958",1,0,0,0,0,0.784583331571564,1
"40959",1,0,0,0,0,0.784583331571564,1
"40960",1,0,0,0,0,0.784583331571564,1
"40961",1,0,0,0,0,0.784583331571564,1
"40962",1,0,0,0,0,0.784583331571564,1
"40963",1,0,0,0,0,0.784583331571564,1
"40964",1,0,0,0,0,0.784583331571564,1
"40965",1,0,0,0,0,0.784583331571564,1
"40966",1,0,0,0,0,0.784583331571564,1
"40967",1,0,0,0,0,0.784583331571564,1
"40968",1,0,0,0,0,0.784583331571564,1
"40969",1,0,0,0,0,0.784583331571564,1
"40970",1,0,0,0,0,0.784583331571564,1
"40971",1,0,0,0,0,0.784583331571564,1
"40972",1,0,0,0,0,0.784583331571564,1
"40973",1,0,0,0,0,0.784583331571564,1
"40974",1,0,0,0,0,0.784583331571564,1
"40975",1,0,0,0,0,0.784583331571564,1
"40976",1,0,0,0,0,0.784583331571564,1
"40977",1,0,0,0,0,0.784583331571564,1
"40978",1,0,0,0,0,0.784583331571564,1
"40979",1,0,0,0,0,0.784583331571564,1
"40980",1,0,0,0,0,0.784583331571564,1
"40981",1,0,0,0,0,0.784583331571564,1
"40982",1,0,0,0,0,0.784583331571564,1
"40983",1,0,0,0,0,0.784583331571564,1
"40984",1,0,0,0,0,0.784583331571564,1
"40985",1,0,0,0,0,0.784583331571564,1
"40986",1,0,0,0,0,0.784583331571564,1
"40987",1,0,0,0,0,0.784583331571564,1
"40988",1,0,0,0,0,0.784583331571564,1
"40989",1,0,0,0,0,0.784583331571564,1
"40990",1,0,0,0,0,0.784583331571564,1
"40991",1,0,0,0,0,0.784583331571564,1
"40992",1,0,0,0,0,0.784583331571564,1
"40993",1,0,0,0,0,0.784583331571564,1
"40994",1,0,0,0,0,0.784583331571564,1
"40995",1,0,0,0,0,0.784583331571564,1
"40996",1,0,0,0,0,0.784583331571564,1
"40997",1,0,0,0,0,0.784583331571564,1
"40998",1,0,0,0,0,0.784583331571564,1
"40999",1,0,0,0,0,0.784583331571564,1
"41000",1,0,0,0,0,0.784583331571564,1
"41001",1,0,0,0,0,0.784583331571564,1
"41002",1,0,0,0,0,0.784583331571564,1
"41003",1,0,0,0,0,0.784583331571564,1
"41004",1,0,0,0,0,0.784583331571564,1
"41005",1,0,0,0,0,0.784583331571564,1
"41006",1,0,0,0,0,0.784583331571564,1
"41007",1,0,0,0,0,0.784583331571564,1
"41008",1,0,0,0,0,0.784583331571564,1
"41009",1,0,0,0,0,0.784583331571564,1
"41010",1,0,0,0,0,0.784583331571564,1
"41011",1,0,0,0,0,0.784583331571564,1
"41012",1,0,0,0,0,0.784583331571564,1
"41013",1,0,0,0,0,0.784583331571564,1
"41014",1,0,0,0,0,0.784583331571564,1
"41015",1,0,0,0,0,0.784583331571564,1
"41016",1,0,0,0,0,0.784583331571564,1
"41017",1,0,0,0,0,0.784583331571564,1
"41018",1,0,0,0,0,0.784583331571564,1
"41019",1,0,0,0,0,0.784583331571564,1
"41020",1,0,0,0,0,0.784583331571564,1
"41021",1,0,0,0,0,0.784583331571564,1
"41022",1,0,0,0,0,0.784583331571564,1
"41023",1,0,0,0,0,0.784583331571564,1
"41024",1,0,0,0,0,0.784583331571564,1
"41025",1,0,0,0,0,0.784583331571564,1
"41026",1,0,0,0,0,0.784583331571564,1
"41027",1,0,0,0,0,0.784583331571564,1
"41028",1,0,0,0,0,0.784583331571564,1
"41029",1,0,0,0,0,0.784583331571564,1
"41030",1,0,0,0,0,0.784583331571564,1
"41031",1,0,0,0,0,0.784583331571564,1
"41032",1,0,0,0,0,0.784583331571564,1
"41033",1,0,0,0,0,0.784583331571564,1
"41034",1,0,0,0,0,0.784583331571564,1
"41035",1,0,0,0,0,0.784583331571564,1
"41036",1,0,0,0,0,0.784583331571564,1
"41037",1,0,0,0,0,0.784583331571564,1
"41038",1,0,0,0,0,0.784583331571564,1
"41039",1,0,0,0,0,0.784583331571564,1
"41040",1,0,0,0,0,0.784583331571564,1
"41041",1,0,0,0,0,0.784583331571564,1
"41042",1,0,0,0,0,0.784583331571564,1
"41043",1,0,0,0,0,0.784583331571564,1
"41044",1,0,0,0,0,0.784583331571564,1
"41045",1,0,0,0,0,0.784583331571564,1
"41046",1,0,0,0,0,0.784583331571564,1
"41047",1,0,0,0,0,0.784583331571564,1
"41048",1,0,0,0,0,0.784583331571564,1
"41049",1,0,0,0,0,0.784583331571564,1
"41050",1,0,0,0,0,0.784583331571564,1
"41051",1,0,0,0,0,0.784583331571564,1
"41052",1,0,0,0,0,0.784583331571564,1
"41053",1,0,0,0,0,0.784583331571564,1
"41054",1,0,0,0,0,0.784583331571564,1
"41055",1,0,0,0,0,0.784583331571564,1
"41056",1,0,0,0,0,0.784583331571564,1
"41057",1,0,0,0,0,0.784583331571564,1
"41058",1,0,0,0,0,0.784583331571564,1
"41059",1,0,0,0,0,0.784583331571564,1
"41060",1,0,0,0,0,0.784583331571564,1
"41061",1,0,0,0,0,0.784583331571564,1
"41062",1,0,0,0,0,0.784583331571564,1
"41063",1,0,0,0,0,0.784583331571564,1
"41064",1,0,0,0,0,0.784583331571564,1
"41065",1,0,0,0,0,0.784583331571564,1
"41066",1,0,0,0,0,0.784583331571564,1
"41067",1,0,0,0,0,0.784583331571564,1
"41068",1,0,0,0,0,0.784583331571564,1
"41069",1,0,0,0,0,0.784583331571564,1
"41070",1,0,0,0,0,0.784583331571564,1
"41071",1,0,0,0,0,0.784583331571564,1
"41072",1,0,0,0,0,0.784583331571564,1
"41073",1,0,0,0,0,0.784583331571564,1
"41074",1,0,0,0,0,0.784583331571564,1
"41075",1,0,0,0,0,0.784583331571564,1
"41076",1,0,0,0,0,0.784583331571564,1
"41077",1,0,0,0,0,0.784583331571564,1
"41078",1,0,0,0,0,0.784583331571564,1
"41079",1,0,0,0,0,0.784583331571564,1
"41080",1,0,0,0,0,0.784583331571564,1
"41081",1,0,0,0,0,0.784583331571564,1
"41082",1,0,0,0,0,0.784583331571564,1
"41083",1,0,0,0,0,0.784583331571564,1
"41084",1,0,0,0,0,0.784583331571564,1
"41085",1,0,0,0,0,0.784583331571564,1
"41086",1,0,0,0,0,0.784583331571564,1
"41087",1,0,0,0,0,0.784583331571564,1
"41088",1,0,0,0,0,0.784583331571564,1
"41089",1,0,0,0,0,0.784583331571564,1
"41090",1,0,0,0,0,0.784583331571564,1
"41091",1,0,0,0,0,0.784583331571564,1
"41092",1,0,0,0,0,0.784583331571564,1
"41093",1,0,0,0,0,0.784583331571564,1
"41094",1,0,0,0,0,0.784583331571564,1
"41095",1,0,0,0,0,0.784583331571564,1
"41096",1,0,0,0,0,0.784583331571564,1
"41097",1,0,0,0,0,0.784583331571564,1
"41098",1,0,0,0,0,0.784583331571564,1
"41099",1,0,0,0,0,0.784583331571564,1
"41100",1,0,0,0,0,0.784583331571564,1
"41101",1,0,0,0,0,0.784583331571564,1
"41102",1,0,0,0,0,0.784583331571564,1
"41103",1,0,0,0,0,0.784583331571564,1
"41104",1,0,0,0,0,0.784583331571564,1
"41105",1,0,0,0,0,0.784583331571564,1
"41106",1,0,0,0,0,0.784583331571564,1
"41107",1,0,0,0,0,0.784583331571564,1
"41108",1,0,0,0,0,0.784583331571564,1
"41109",1,0,0,0,0,0.784583331571564,1
"41110",1,0,0,0,0,0.784583331571564,1
"41111",1,0,0,0,0,0.784583331571564,1
"41112",1,0,0,0,0,0.784583331571564,1
"41113",1,0,0,0,0,0.784583331571564,1
"41114",1,0,0,0,0,0.784583331571564,1
"41115",1,0,0,0,0,0.784583331571564,1
"41116",1,0,0,0,0,0.784583331571564,1
"41117",1,0,0,0,0,0.784583331571564,1
"41118",1,0,0,0,0,0.784583331571564,1
"41119",1,0,0,0,0,0.784583331571564,1
"41120",1,0,0,0,0,0.784583331571564,1
"41121",1,0,0,0,0,0.784583331571564,1
"41122",1,0,0,0,0,0.784583331571564,1
"41123",1,0,0,0,0,0.784583331571564,1
"41124",1,0,0,0,0,0.784583331571564,1
"41125",1,0,0,0,0,0.784583331571564,1
"41126",1,0,0,0,0,0.784583331571564,1
"41127",1,0,0,0,0,0.784583331571564,1
"41128",1,0,0,0,0,0.784583331571564,1
"41129",1,0,0,0,0,0.784583331571564,1
"41130",1,0,0,0,0,0.784583331571564,1
"41131",1,0,0,0,0,0.784583331571564,1
"41132",1,0,0,0,0,0.784583331571564,1
"41133",1,0,0,0,0,0.784583331571564,1
"41134",1,0,0,0,0,0.784583331571564,1
"41135",1,0,0,0,0,0.784583331571564,1
"41136",1,0,0,0,0,0.784583331571564,1
"41137",1,0,0,0,0,0.784583331571564,1
"41138",1,0,0,0,0,0.784583331571564,1
"41139",1,0,0,0,0,0.784583331571564,1
"41140",1,0,0,0,0,0.784583331571564,1
"41141",1,0,0,0,0,0.784583331571564,1
"41142",1,0,0,0,0,0.784583331571564,1
"41143",1,0,0,0,0,0.784583331571564,1
"41144",1,0,0,0,0,0.784583331571564,1
"41145",1,0,0,0,0,0.784583331571564,1
"41146",1,0,0,0,0,0.784583331571564,1
"41147",1,0,0,0,0,0.784583331571564,1
"41148",1,0,0,0,0,0.784583331571564,1
"41149",1,0,0,0,0,0.784583331571564,1
"41150",1,0,0,0,0,0.784583331571564,1
"41151",1,0,0,0,0,0.784583331571564,1
"41152",1,0,0,0,0,0.784583331571564,1
"41153",1,0,0,0,0,0.784583331571564,1
"41154",1,0,0,0,0,0.784583331571564,1
"41155",1,0,0,0,0,0.784583331571564,1
"41156",1,0,0,0,0,0.784583331571564,1
"41157",1,0,0,0,0,0.784583331571564,1
"41158",1,0,0,0,0,0.784583331571564,1
"41159",1,0,0,0,0,0.784583331571564,1
"41160",1,0,0,0,0,0.784583331571564,1
"41161",1,0,0,0,0,0.784583331571564,1
"41162",1,0,0,0,0,0.784583331571564,1
"41163",1,0,0,0,0,0.784583331571564,1
"41164",1,0,0,0,0,0.784583331571564,1
"41165",1,0,0,0,0,0.784583331571564,1
"41166",1,0,0,0,0,0.784583331571564,1
"41167",1,0,0,0,0,0.784583331571564,1
"41168",1,0,0,0,0,0.784583331571564,1
"41169",1,0,0,0,0,0.784583331571564,1
"41170",1,0,0,0,0,0.784583331571564,1
"41171",1,0,0,0,0,0.784583331571564,1
"41172",1,0,0,0,0,0.784583331571564,1
"41173",1,0,0,0,0,0.784583331571564,1
"41174",1,0,0,0,0,0.784583331571564,1
"41175",1,0,0,0,0,0.784583331571564,1
"41176",1,0,0,0,0,0.784583331571564,1
"41177",1,0,0,0,0,0.784583331571564,1
"41178",1,0,0,0,0,0.784583331571564,1
"41179",1,0,0,0,0,0.784583331571564,1
"41180",1,0,0,0,0,0.784583331571564,1
"41181",1,0,0,0,0,0.784583331571564,1
"41182",1,0,0,0,0,0.784583331571564,1
"41183",1,0,0,0,0,0.784583331571564,1
"41184",1,0,0,0,0,0.784583331571564,1
"41185",1,0,0,0,0,0.784583331571564,1
"41186",1,0,0,0,0,0.784583331571564,1
"41187",1,0,0,0,0,0.784583331571564,1
"41188",1,0,0,0,0,0.784583331571564,1
"41189",1,0,0,0,0,0.784583331571564,1
"41190",1,0,0,0,0,0.784583331571564,1
"41191",1,0,0,0,0,0.784583331571564,1
"41192",1,0,0,0,0,0.784583331571564,1
"41193",1,0,0,0,0,0.784583331571564,1
"41194",1,0,0,0,0,0.784583331571564,1
"41195",1,0,0,0,0,0.784583331571564,1
"41196",1,0,0,0,0,0.784583331571564,1
"41197",1,0,0,0,0,0.784583331571564,1
"41198",1,0,0,0,0,0.784583331571564,1
"41199",1,0,0,0,0,0.784583331571564,1
"41200",1,0,0,0,0,0.784583331571564,1
"41201",1,0,0,0,0,0.784583331571564,1
"41202",1,0,0,0,0,0.784583331571564,1
"41203",1,0,0,0,0,0.784583331571564,1
"41204",1,0,0,0,0,0.784583331571564,1
"41205",1,0,0,0,0,0.784583331571564,1
"41206",1,0,0,0,0,0.784583331571564,1
"41207",1,0,0,0,0,0.784583331571564,1
"41208",1,0,0,0,0,0.784583331571564,1
"41209",1,0,0,0,0,0.784583331571564,1
"41210",1,0,0,0,0,0.784583331571564,1
"41211",1,0,0,0,0,0.784583331571564,1
"41212",1,0,0,0,0,0.784583331571564,1
"41213",1,0,0,0,0,0.784583331571564,1
"41214",1,0,0,0,0,0.784583331571564,1
"41215",1,0,0,0,0,0.784583331571564,1
"41216",1,0,0,0,0,0.784583331571564,1
"41217",1,0,0,0,0,0.784583331571564,1
"41218",1,0,0,0,0,0.784583331571564,1
"41219",1,0,0,0,0,0.784583331571564,1
"41220",1,0,0,0,0,0.784583331571564,1
"41221",1,0,0,0,0,0.784583331571564,1
"41222",1,0,0,0,0,0.784583331571564,1
"41223",1,0,0,0,0,0.784583331571564,1
"41224",1,0,0,0,0,0.784583331571564,1
"41225",1,0,0,0,0,0.784583331571564,1
"41226",1,0,0,0,0,0.784583331571564,1
"41227",1,0,0,0,0,0.784583331571564,1
"41228",1,0,0,0,0,0.784583331571564,1
"41229",1,0,0,0,0,0.784583331571564,1
"41230",1,0,0,0,0,0.784583331571564,1
"41231",1,0,0,0,0,0.784583331571564,1
"41232",1,0,0,0,0,0.784583331571564,1
"41233",1,0,0,0,0,0.784583331571564,1
"41234",1,0,0,0,0,0.784583331571564,1
"41235",1,0,0,0,0,0.784583331571564,1
"41236",1,0,0,0,0,0.784583331571564,1
"41237",1,0,0,0,0,0.784583331571564,1
"41238",1,0,0,0,0,0.784583331571564,1
"41239",1,0,0,0,0,0.784583331571564,1
"41240",1,0,0,0,0,0.784583331571564,1
"41241",1,0,0,0,0,0.784583331571564,1
"41242",1,0,0,0,0,0.784583331571564,1
"41243",1,0,0,0,0,0.784583331571564,1
"41244",1,0,0,0,0,0.784583331571564,1
"41245",1,0,0,0,0,0.784583331571564,1
"41246",1,0,0,0,0,0.784583331571564,1
"41247",1,0,0,0,0,0.784583331571564,1
"41248",1,0,0,0,0,0.784583331571564,1
"41249",1,0,0,0,0,0.784583331571564,1
"41250",1,0,0,0,0,0.784583331571564,1
"41251",1,0,0,0,0,0.784583331571564,1
"41252",1,0,0,0,0,0.784583331571564,1
"41253",1,0,0,0,0,0.784583331571564,1
"41254",1,0,0,0,0,0.784583331571564,1
"41255",1,0,0,0,0,0.784583331571564,1
"41256",1,0,0,0,0,0.784583331571564,1
"41257",1,0,0,0,0,0.784583331571564,1
"41258",1,0,0,0,0,0.784583331571564,1
"41259",1,0,0,0,0,0.784583331571564,1
"41260",1,0,0,0,0,0.784583331571564,1
"41261",1,0,0,0,0,0.784583331571564,1
"41262",1,0,0,0,0,0.784583331571564,1
"41263",1,0,0,0,0,0.784583331571564,1
"41264",1,0,0,0,0,0.784583331571564,1
"41265",1,0,0,0,0,0.784583331571564,1
"41266",1,0,0,0,0,0.784583331571564,1
"41267",1,0,0,0,0,0.784583331571564,1
"41268",1,0,0,0,0,0.784583331571564,1
"41269",1,0,0,0,0,0.784583331571564,1
"41270",1,0,0,0,0,0.784583331571564,1
"41271",1,0,0,0,0,0.784583331571564,1
"41272",1,0,0,0,0,0.784583331571564,1
"41273",1,0,0,0,0,0.784583331571564,1
"41274",1,0,0,0,0,0.784583331571564,1
"41275",1,0,0,0,0,0.784583331571564,1
"41276",1,0,0,0,0,0.784583331571564,1
"41277",1,0,0,0,0,0.784583331571564,1
"41278",1,0,0,0,0,0.784583331571564,1
"41279",1,0,0,0,0,0.784583331571564,1
"41280",1,0,0,0,0,0.784583331571564,1
"41281",1,0,0,0,0,0.784583331571564,1
"41282",1,0,0,0,0,0.784583331571564,1
"41283",1,0,0,0,0,0.784583331571564,1
"41284",1,0,0,0,0,0.784583331571564,1
"41285",1,0,0,0,0,0.784583331571564,1
"41286",1,0,0,0,0,0.784583331571564,1
"41287",1,0,0,0,0,0.784583331571564,1
"41288",1,0,0,0,0,0.784583331571564,1
"41289",1,0,0,0,0,0.784583331571564,1
"41290",1,0,0,0,0,0.784583331571564,1
"41291",1,0,0,0,0,0.784583331571564,1
"41292",1,0,0,0,0,0.784583331571564,1
"41293",1,0,0,0,0,0.784583331571564,1
"41294",1,0,0,0,0,0.784583331571564,1
"41295",1,0,0,0,0,0.784583331571564,1
"41296",1,0,0,0,0,0.784583331571564,1
"41297",1,0,0,0,0,0.784583331571564,1
"41298",1,0,0,0,0,0.784583331571564,1
"41299",1,0,0,0,0,0.784583331571564,1
"41300",1,0,0,0,0,0.784583331571564,1
"41301",1,0,0,0,0,0.784583331571564,1
"41302",1,0,0,0,0,0.784583331571564,1
"41303",1,0,0,0,0,0.784583331571564,1
"41304",1,0,0,0,0,0.784583331571564,1
"41305",1,0,0,0,0,0.784583331571564,1
"41306",1,0,0,0,0,0.784583331571564,1
"41307",1,0,0,0,0,0.784583331571564,1
"41308",1,0,0,0,0,0.784583331571564,1
"41309",1,0,0,0,0,0.784583331571564,1
"41310",1,0,0,0,0,0.784583331571564,1
"41311",1,0,0,0,0,0.784583331571564,1
"41312",1,0,0,0,0,0.784583331571564,1
"41313",1,0,0,0,0,0.784583331571564,1
"41314",1,0,0,0,0,0.784583331571564,1
"41315",1,0,0,0,0,0.784583331571564,1
"41316",1,0,0,0,0,0.784583331571564,1
"41317",1,0,0,0,0,0.784583331571564,1
"41318",1,0,0,0,0,0.784583331571564,1
"41319",1,0,0,0,0,0.784583331571564,1
"41320",1,0,0,0,0,0.784583331571564,1
"41321",1,0,0,0,0,0.784583331571564,1
"41322",1,0,0,0,0,0.784583331571564,1
"41323",1,0,0,0,0,0.784583331571564,1
"41324",1,0,0,0,0,0.784583331571564,1
"41325",1,0,0,0,0,0.784583331571564,1
"41326",1,0,0,0,0,0.784583331571564,1
"41327",1,0,0,0,0,0.784583331571564,1
"41328",1,0,0,0,0,0.784583331571564,1
"41329",1,0,0,0,0,0.784583331571564,1
"41330",1,0,0,0,0,0.784583331571564,1
"41331",1,0,0,0,0,0.784583331571564,1
"41332",1,0,0,0,0,0.784583331571564,1
"41333",1,0,0,0,0,0.784583331571564,1
"41334",1,0,0,0,0,0.784583331571564,1
"41335",1,0,0,0,0,0.784583331571564,1
"41336",1,0,0,0,0,0.784583331571564,1
"41337",1,0,0,0,0,0.784583331571564,1
"41338",1,0,0,0,0,0.784583331571564,1
"41339",1,0,0,0,0,0.784583331571564,1
"41340",1,0,0,0,0,0.784583331571564,1
"41341",1,0,0,0,0,0.784583331571564,1
"41342",1,0,0,0,0,0.784583331571564,1
"41343",1,0,0,0,0,0.784583331571564,1
"41344",1,0,0,0,0,0.784583331571564,1
"41345",1,0,0,0,0,0.784583331571564,1
"41346",1,0,0,0,0,0.784583331571564,1
"41347",1,0,0,0,0,0.784583331571564,1
"41348",1,0,0,0,0,0.784583331571564,1
"41349",1,0,0,0,0,0.784583331571564,1
"41350",1,0,0,0,0,0.784583331571564,1
"41351",1,0,0,0,0,0.784583331571564,1
"41352",1,0,0,0,0,0.784583331571564,1
"41353",1,0,0,0,0,0.784583331571564,1
"41354",1,0,0,0,0,0.784583331571564,1
"41355",1,0,0,0,0,0.784583331571564,1
"41356",1,0,0,0,0,0.784583331571564,1
"41357",1,0,0,0,0,0.784583331571564,1
"41358",1,0,0,0,0,0.784583331571564,1
"41359",1,0,0,0,0,0.784583331571564,1
"41360",1,0,0,0,0,0.784583331571564,1
"41361",1,0,0,0,0,0.784583331571564,1
"41362",1,0,0,0,0,0.784583331571564,1
"41363",1,0,0,0,0,0.784583331571564,1
"41364",1,0,0,0,0,0.784583331571564,1
"41365",1,0,0,0,0,0.784583331571564,1
"41366",1,0,0,0,0,0.784583331571564,1
"41367",1,0,0,0,0,0.784583331571564,1
"41368",1,0,0,0,0,0.784583331571564,1
"41369",1,0,0,0,0,0.784583331571564,1
"41370",1,0,0,0,0,0.784583331571564,1
"41371",1,0,0,0,0,0.784583331571564,1
"41372",1,0,0,0,0,0.784583331571564,1
"41373",1,0,0,0,0,0.784583331571564,1
"41374",1,0,0,0,0,0.784583331571564,1
"41375",1,0,0,0,0,0.784583331571564,1
"41376",1,0,0,0,0,0.784583331571564,1
"41377",1,0,0,0,0,0.784583331571564,1
"41378",1,0,0,0,0,0.784583331571564,1
"41379",1,0,0,0,0,0.784583331571564,1
"41380",1,0,0,0,0,0.784583331571564,1
"41381",1,0,0,0,0,0.784583331571564,1
"41382",1,0,0,0,0,0.784583331571564,1
"41383",1,0,0,0,0,0.784583331571564,1
"41384",1,0,0,0,0,0.784583331571564,1
"41385",1,0,0,0,0,0.784583331571564,1
"41386",1,0,0,0,0,0.784583331571564,1
"41387",1,0,0,0,0,0.784583331571564,1
"41388",1,0,0,0,0,0.784583331571564,1
"41389",1,0,0,0,0,0.784583331571564,1
"41390",1,0,0,0,0,0.784583331571564,1
"41391",1,0,0,0,0,0.784583331571564,1
"41392",1,0,0,0,0,0.784583331571564,1
"41393",1,0,0,0,0,0.784583331571564,1
"41394",1,0,0,0,0,0.784583331571564,1
"41395",1,0,0,0,0,0.784583331571564,1
"41396",1,0,0,0,0,0.784583331571564,1
"41397",1,0,0,0,0,0.784583331571564,1
"41398",1,0,0,0,0,0.784583331571564,1
"41399",1,0,0,0,0,0.784583331571564,1
"41400",1,0,0,0,0,0.784583331571564,1
"41401",1,0,0,0,0,0.784583331571564,1
"41402",1,0,0,0,0,0.784583331571564,1
"41403",1,0,0,0,0,0.784583331571564,1
"41404",1,0,0,0,0,0.784583331571564,1
"41405",1,0,0,0,0,0.784583331571564,1
"41406",1,0,0,0,0,0.784583331571564,1
"41407",1,0,0,0,0,0.784583331571564,1
"41408",1,0,0,0,0,0.784583331571564,1
"41409",1,0,0,0,0,0.784583331571564,1
"41410",1,0,0,0,0,0.784583331571564,1
"41411",1,0,0,0,0,0.784583331571564,1
"41412",1,0,0,0,0,0.784583331571564,1
"41413",1,0,0,0,0,0.784583331571564,1
"41414",1,0,0,0,0,0.784583331571564,1
"41415",1,0,0,0,0,0.784583331571564,1
"41416",1,0,0,0,0,0.784583331571564,1
"41417",1,0,0,0,0,0.784583331571564,1
"41418",1,0,0,0,0,0.784583331571564,1
"41419",1,0,0,0,0,0.784583331571564,1
"41420",1,0,0,0,0,0.784583331571564,1
"41421",1,0,0,0,0,0.784583331571564,1
"41422",1,0,0,0,0,0.784583331571564,1
"41423",1,0,0,0,0,0.784583331571564,1
"41424",1,0,0,0,0,0.784583331571564,1
"41425",1,0,0,0,0,0.784583331571564,1
"41426",1,0,0,0,0,0.784583331571564,1
"41427",1,0,0,0,0,0.784583331571564,1
"41428",1,0,0,0,0,0.784583331571564,1
"41429",1,0,0,0,0,0.784583331571564,1
"41430",1,0,0,0,0,0.784583331571564,1
"41431",1,0,0,0,0,0.784583331571564,1
"41432",1,0,0,0,0,0.784583331571564,1
"41433",1,0,0,0,0,0.784583331571564,1
"41434",1,0,0,0,0,0.784583331571564,1
"41435",1,0,0,0,0,0.784583331571564,1
"41436",1,0,0,0,0,0.784583331571564,1
"41437",1,0,0,0,0,0.784583331571564,1
"41438",1,0,0,0,0,0.784583331571564,1
"41439",1,0,0,0,0,0.784583331571564,1
"41440",1,0,0,0,0,0.784583331571564,1
"41441",1,0,0,0,0,0.784583331571564,1
"41442",1,0,0,0,0,0.784583331571564,1
"41443",1,0,0,0,0,0.784583331571564,1
"41444",1,0,0,0,0,0.784583331571564,1
"41445",1,0,0,0,0,0.784583331571564,1
"41446",1,0,0,0,0,0.784583331571564,1
"41447",1,0,0,0,0,0.784583331571564,1
"41448",1,0,0,0,0,0.784583331571564,1
"41449",1,0,0,0,0,0.784583331571564,1
"41450",1,0,0,0,0,0.784583331571564,1
"41451",1,0,0,0,0,0.784583331571564,1
"41452",1,0,0,0,0,0.784583331571564,1
"41453",1,0,0,0,0,0.784583331571564,1
"41454",1,0,0,0,0,0.784583331571564,1
"41455",1,0,0,0,0,0.784583331571564,1
"41456",1,0,0,0,0,0.784583331571564,1
"41457",1,0,0,0,0,0.784583331571564,1
"41458",1,0,0,0,0,0.784583331571564,1
"41459",1,0,0,0,0,0.784583331571564,1
"41460",1,0,0,0,0,0.784583331571564,1
"41461",1,0,0,0,0,0.784583331571564,1
"41462",1,0,0,0,0,0.784583331571564,1
"41463",1,0,0,0,0,0.784583331571564,1
"41464",1,0,0,0,0,0.784583331571564,1
"41465",1,0,0,0,0,0.784583331571564,1
"41466",1,0,0,0,0,0.784583331571564,1
"41467",1,0,0,0,0,0.784583331571564,1
"41468",1,0,0,0,0,0.784583331571564,1
"41469",1,0,0,0,0,0.784583331571564,1
"41470",1,0,0,0,0,0.784583331571564,1
"41471",1,0,0,0,0,0.784583331571564,1
"41472",1,0,0,0,0,0.784583331571564,1
"41473",1,0,0,0,0,0.784583331571564,1
"41474",1,0,0,0,0,0.784583331571564,1
"41475",1,0,0,0,0,0.784583331571564,1
"41476",1,0,0,0,0,0.784583331571564,1
"41477",1,0,0,0,0,0.784583331571564,1
"41478",1,0,0,0,0,0.784583331571564,1
"41479",1,0,0,0,0,0.784583331571564,1
"41480",1,0,0,0,0,0.784583331571564,1
"41481",1,0,0,0,0,0.784583331571564,1
"41482",1,0,0,0,0,0.784583331571564,1
"41483",1,0,0,0,0,0.784583331571564,1
"41484",1,0,0,0,0,0.784583331571564,1
"41485",1,0,0,0,0,0.784583331571564,1
"41486",1,0,0,0,0,0.784583331571564,1
"41487",1,0,0,0,0,0.784583331571564,1
"41488",1,0,0,0,0,0.784583331571564,1
"41489",1,0,0,0,0,0.784583331571564,1
"41490",1,0,0,0,0,0.784583331571564,1
"41491",1,0,0,0,0,0.784583331571564,1
"41492",1,0,0,0,0,0.784583331571564,1
"41493",1,0,0,0,0,0.784583331571564,1
"41494",1,0,0,0,0,0.784583331571564,1
"41495",1,0,0,0,0,0.784583331571564,1
"41496",1,0,0,0,0,0.784583331571564,1
"41497",1,0,0,0,0,0.784583331571564,1
"41498",1,0,0,0,0,0.784583331571564,1
"41499",1,0,0,0,0,0.784583331571564,1
"41500",1,0,0,0,0,0.784583331571564,1
